Time,Team,Operation,BuyVolume,SellVolume,EtfPosition,FuturePosition,EtfPrice,FuturePrice,TotalFees,AccountBalance,ProfitOrLoss,Status
8e-06,delay,Tick,0,0,0,0,,,0,0,0,OK
0.256622,delay,Tick,0,0,0,0,,,0,0,0,OK
0.524541,delay,Tick,0,0,0,0,,,0,0,0,OK
0.794468,delay,Tick,0,0,0,0,,,0,0,0,OK
1.000225,delay,Tick,0,0,0,0,,140400,0,0,0,OK
1.28783,delay,Tick,0,0,0,0,,140400,0,0,0,OK
1.543363,delay,Tick,0,0,0,0,,140400,0,0,0,OK
1.714011,delay,Tick,0,0,0,0,,140400,0,0,0,OK
2.036089,delay,Tick,0,10,-10,10,141000,140400,-141,2141,141,OK
2.290885,delay,Tick,0,10,-10,10,141000,140400,-141,2141,141,OK
2.542416,delay,Tick,0,10,-10,10,141000,140600,-141,2141,141,OK
2.749127,delay,Tick,0,20,-20,20,141100,140600,-282,4282,282,OK
2.957318,delay,Tick,0,20,-20,20,141100,140600,-282,4282,282,OK
3.223558,delay,Tick,0,20,-20,20,141100,140600,-282,4282,282,OK
3.479793,delay,Tick,0,20,-20,20,141100,140600,-282,4282,282,OK
3.757704,delay,Tick,0,20,-20,20,141100,140600,-282,4282,282,OK
3.950698,delay,Tick,0,20,-20,20,141100,140600,-282,4282,282,OK
4.267432,delay,Tick,0,30,-30,30,141200,140600,-423,6423,423,OK
4.525491,delay,Tick,0,30,-30,30,141200,140600,-423,6423,423,OK
4.799626,delay,Tick,0,30,-30,30,141200,140500,-423,6423,423,OK
5.029311,delay,Tick,10,30,-20,20,139900,140400,-563,9563,13563,OK
5.21979,delay,Tick,10,30,-20,20,139900,140400,-563,9563,13563,OK
5.539934,delay,Tick,13,40,-27,27,140600,140400,-746,12946,7546,OK
5.797734,delay,Tick,13,50,-37,37,140600,140400,-465,14665,7265,OK
6.032865,delay,Tick,13,60,-47,47,140600,140400,-184,16384,6984,OK
6.21167,delay,Tick,13,70,-57,57,140900,140400,97,18103,6703,OK
6.467274,delay,Tick,13,80,-67,67,140600,140400,378,19822,6422,OK
6.727094,delay,Tick,13,80,-67,67,140600,140400,378,19822,6422,OK
6.95641,delay,Tick,13,80,-67,67,140600,140400,378,19822,6422,OK
7.296225,delay,Tick,13,80,-67,67,140600,140400,378,19822,6422,OK
7.493436,delay,Tick,13,80,-67,67,140600,140400,378,19822,6422,OK
7.73261,delay,Tick,23,80,-57,57,139800,140400,238,23962,35362,OK
8.044031,delay,Tick,33,80,-47,47,139900,140400,518,27682,37082,OK
8.228674,delay,Tick,43,80,-37,37,139900,140400,798,31402,38802,OK
8.483406,delay,Tick,53,80,-27,27,139900,140400,1078,35122,40522,OK
8.715322,delay,Tick,63,80,-17,17,139900,140400,1358,38842,42242,OK
9.048716,delay,Tick,73,80,-7,7,139900,140400,1638,42562,43962,OK
9.288932,delay,Tick,77,80,-3,3,140300,140400,1750,44050,44350,OK
9.513106,delay,Tick,77,80,-3,3,140300,140400,1750,44050,44350,OK
9.750522,delay,Tick,77,80,-3,3,140300,140400,1750,44050,44350,OK
9.98976,delay,Tick,77,80,-3,3,140300,140400,1750,44050,44350,OK
10.29981,delay,Tick,77,80,-3,3,140300,140400,1750,44050,44350,OK
10.547766,delay,Tick,77,90,-13,13,140700,140500,1609,46191,43591,OK
10.767631,delay,Tick,77,100,-23,23,140900,140500,1891,47909,43309,OK
10.996526,delay,Tick,77,110,-33,33,140900,140500,2173,49627,43027,OK
11.248403,delay,Tick,77,110,-33,33,140900,140500,2173,49627,43027,OK
11.489577,delay,Tick,77,110,-33,33,140900,140500,2173,49627,43027,OK
11.711554,delay,Tick,77,110,-33,33,140900,140500,2173,49627,43027,OK
11.980809,delay,Tick,77,110,-33,33,140900,140500,2173,49627,43027,OK
12.223412,delay,Tick,77,110,-33,33,140900,140500,2173,49627,43027,OK
12.549522,delay,Tick,77,110,-33,33,140900,140500,2173,49627,43027,OK
12.7503,delay,Tick,87,110,-23,23,140000,140500,2033,53767,58367,OK
12.972973,delay,Tick,87,110,-23,23,140000,140500,2033,53767,58367,OK
13.297119,delay,Tick,87,110,-23,23,140000,140500,2033,53767,58367,OK
13.500086,delay,Tick,97,110,-13,13,140100,140500,1893,55907,58507,OK
13.790943,delay,Tick,97,120,-23,23,141300,140400,1752,61048,56448,OK
13.952951,delay,Tick,97,120,-23,23,141300,140400,1752,61048,56448,OK
14.301633,delay,Tick,97,120,-23,23,141300,140400,1752,61048,56448,OK
14.528951,delay,Tick,97,120,-23,23,141300,140400,1752,61048,56448,OK
14.706953,delay,Tick,97,120,-23,23,141300,140400,1752,61048,56448,OK
14.987629,delay,Tick,97,130,-33,33,141100,140400,1611,62189,55589,OK
15.240351,delay,Tick,97,130,-33,33,141100,140400,1611,62189,55589,OK
15.539469,delay,Tick,97,130,-33,33,140400,140400,1611,62189,62189,OK
15.719467,delay,Tick,97,130,-33,33,140400,140400,1611,62189,62189,OK
16.015421,delay,Tick,97,130,-33,33,140400,140400,1611,62189,62189,OK
16.241696,delay,Tick,97,130,-33,33,140400,140400,1611,62189,62189,OK
16.53728,delay,Tick,97,130,-33,33,140400,140400,1611,62189,62189,OK
16.708773,delay,Tick,97,130,-33,33,140400,140400,1611,62189,62189,OK
16.951894,delay,Tick,97,130,-33,33,140400,140400,1611,62189,62189,OK
17.298617,delay,Tick,97,130,-33,33,140400,140400,1611,62189,62189,OK
17.461821,delay,Tick,97,130,-33,33,140400,140400,1611,62189,62189,OK
17.741721,delay,Tick,97,130,-33,33,140400,140400,1611,62189,62189,OK
17.970021,delay,Tick,97,130,-33,33,140400,140400,1611,62189,62189,OK
18.269721,delay,Tick,97,130,-33,33,140100,140400,1611,62189,68789,OK
18.513707,delay,Tick,97,130,-33,33,140100,140300,1611,62189,68789,OK
18.717423,delay,Tick,97,130,-33,33,140100,140300,1611,62189,68789,OK
19.043605,delay,Tick,97,130,-33,33,140100,140300,1611,62189,68789,OK
19.239738,delay,Tick,97,130,-33,33,140100,140300,1611,62189,68789,OK
19.473942,delay,Tick,97,130,-33,33,140100,140300,1611,62189,68789,OK
19.739546,delay,Tick,97,130,-33,33,140200,140300,1611,62189,65489,OK
20.033414,delay,Tick,97,130,-33,33,140200,140300,1611,62189,65489,OK
20.256141,delay,Tick,97,130,-33,33,140200,140300,1611,62189,65489,OK
20.478367,delay,Tick,97,130,-33,33,140200,140500,1611,62189,68789,OK
20.788746,delay,Tick,104,130,-26,26,140200,140500,1807,63393,68593,OK
20.966005,delay,Tick,104,130,-26,26,140200,140500,1807,63393,68593,OK
21.296703,delay,Tick,104,130,-26,26,140200,140500,1807,63393,68593,OK
21.472291,delay,Tick,104,130,-26,26,140200,140300,1807,63393,65993,OK
21.736974,delay,Tick,104,130,-26,26,140200,140300,1807,63393,65993,OK
21.974776,delay,Tick,104,130,-26,26,140200,140300,1807,63393,65993,OK
22.218886,delay,Tick,104,130,-26,26,140200,140100,1807,63393,60793,OK
22.459699,delay,Tick,104,130,-26,26,139900,140100,1807,63393,68593,OK
22.723803,delay,Tick,104,130,-26,26,139900,140000,1807,63393,65993,OK
23.017351,delay,Tick,104,130,-26,26,139900,140000,1807,63393,65993,OK
23.213086,delay,Tick,104,130,-26,26,139900,139800,1807,63393,60793,OK
23.475433,delay,Tick,104,130,-26,26,139900,139800,1807,63393,60793,OK
23.797265,delay,Tick,104,130,-26,26,139900,139800,1807,63393,60793,OK
23.975104,delay,Tick,104,140,-36,36,140200,139800,1667,65533,58333,OK
24.265815,delay,Tick,104,140,-36,36,140200,139800,1667,65533,58333,OK
24.515991,delay,Tick,104,140,-36,36,140200,139800,1667,65533,58333,OK
24.794672,delay,Tick,104,140,-36,36,140200,139800,1667,65533,58333,OK
24.994074,delay,Tick,104,140,-36,36,140200,139800,1667,65533,58333,OK
25.235628,delay,Tick,104,140,-36,36,140200,139800,1667,65533,58333,OK
25.463372,delay,Tick,104,140,-36,36,140200,139800,1667,65533,58333,OK
25.746799,delay,Tick,104,140,-36,36,140200,139800,1667,65533,58333,OK
26.016051,delay,Tick,104,140,-36,36,140200,139800,1667,65533,58333,OK
26.276134,delay,Tick,104,140,-36,36,140200,139800,1667,65533,58333,OK
26.508898,delay,Tick,104,140,-36,36,140200,139800,1667,65533,58333,OK
26.757654,delay,Tick,104,150,-46,46,140400,139800,1527,67673,58473,OK
26.976244,delay,Tick,104,150,-46,46,140400,139800,1527,67673,58473,OK
27.232385,delay,Tick,104,150,-46,46,140400,139800,1527,67673,58473,OK
27.518231,delay,Tick,104,150,-46,46,139900,139800,1527,67673,63073,OK
27.776675,delay,Tick,104,150,-46,46,139900,139700,1527,67673,58473,OK
27.999857,delay,Tick,104,150,-46,46,139900,139800,1527,67673,63073,OK
28.29981,delay,Tick,104,160,-56,56,140100,139800,1387,69813,58613,OK
28.546146,delay,Tick,104,170,-66,66,140100,139800,1667,71533,58333,OK
28.741948,delay,Tick,104,180,-76,76,140100,139800,1947,73253,58053,OK
28.974313,delay,Tick,104,190,-86,86,140100,139800,2227,76973,59773,OK
29.219393,delay,Tick,104,194,-90,90,140200,139800,2339,78461,60461,OK
29.467829,delay,Tick,104,194,-90,90,140200,140000,2339,78461,60461,OK
29.793088,delay,Tick,104,194,-90,90,140200,140000,2339,78461,60461,OK
29.961034,delay,Tick,104,194,-90,90,140200,140000,2339,78461,60461,OK
30.262898,delay,Tick,104,194,-90,90,140200,140000,2339,78461,60461,OK
30.534443,delay,Tick,104,194,-90,90,140200,140000,2339,78461,60461,OK
30.76213,delay,Tick,104,194,-90,90,140200,140000,2339,78461,60461,OK
31.045174,delay,Tick,104,194,-90,90,139800,140000,2339,78461,96461,OK
31.288554,delay,Tick,104,194,-90,90,139800,140000,2339,78461,96461,OK
31.544041,delay,Tick,104,194,-90,90,139800,140000,2339,78461,96461,OK
31.784178,delay,Tick,104,194,-90,90,139800,140000,2339,78461,96461,OK
32.01638,delay,Tick,104,194,-90,90,139800,140000,2339,78461,96461,OK
32.297806,delay,Tick,104,194,-90,90,139800,140100,2339,78461,96461,OK
32.547316,delay,Tick,104,194,-90,90,139800,140100,2339,78461,96461,OK
32.774434,delay,Tick,104,194,-90,90,139800,140100,2339,78461,96461,OK
33.034546,delay,Tick,104,194,-90,90,139800,140100,2339,78461,96461,OK
33.236945,delay,Tick,104,194,-90,90,139800,140200,2339,78461,96461,OK
33.492104,delay,Tick,104,194,-90,90,139800,140200,2339,78461,96461,OK
33.720517,delay,Tick,104,194,-90,90,139800,140200,2339,78461,96461,OK
33.987185,delay,Tick,104,194,-90,90,139800,140200,2339,78461,96461,OK
34.282953,delay,Tick,104,194,-90,90,139800,140300,2339,78461,96461,OK
34.488152,delay,Tick,123,194,-71,71,140200,140300,2872,81728,88828,OK
34.789325,delay,Tick,133,194,-61,61,140300,140700,3153,83447,95647,OK
34.989561,delay,Tick,143,194,-51,51,140300,140700,3434,87166,97366,OK
35.259767,delay,Tick,153,194,-41,41,140300,140700,3715,90885,99085,OK
35.520328,delay,Tick,163,194,-31,31,140400,140800,3995,94105,100305,OK
35.751035,delay,Tick,173,194,-21,21,140400,140800,4276,96824,101024,OK
36.040574,delay,Tick,183,194,-11,11,140200,140800,4346,98754,100954,OK
36.290001,delay,Tick,183,194,-11,11,140200,140800,4346,98754,100954,OK
36.534697,delay,Tick,193,194,-1,1,140500,140800,4206,100894,101094,OK
36.742255,delay,Tick,203,194,9,-9,140500,140800,4487,102613,100813,OK
36.963187,delay,Tick,213,194,19,-19,140500,140800,4768,104332,100532,OK
37.212589,delay,Tick,223,194,29,-29,140200,140800,4628,106772,100972,OK
37.458236,delay,Tick,233,194,39,-39,140500,140800,4909,108491,100691,OK
37.78531,delay,Tick,233,194,39,-39,140500,140800,4909,108491,100691,OK
37.953092,delay,Tick,233,194,39,-39,140500,140800,4909,108491,100691,OK
38.230014,delay,Tick,243,194,49,-49,140100,140800,4769,110631,100831,OK
38.532266,delay,Tick,253,194,59,-59,140500,140800,5050,111350,99550,OK
38.726576,delay,Tick,263,194,69,-69,140100,140800,5331,113069,99269,OK
38.996997,delay,Tick,273,194,79,-79,140500,140700,5612,114788,98988,OK
39.277982,delay,Tick,283,194,89,-89,140000,140700,5472,115928,98128,OK
39.520571,delay,Tick,283,194,89,-89,140000,140700,5472,115928,98128,OK
39.799394,delay,Tick,283,194,89,-89,140000,140500,5472,115928,98128,OK
39.987909,delay,Tick,283,194,89,-89,140000,140500,5472,115928,98128,OK
40.205363,delay,Tick,283,194,89,-89,140000,140500,5472,115928,98128,OK
40.472391,delay,Tick,283,196,87,-87,140800,140500,5444,116356,133756,OK
40.787436,delay,Tick,283,196,87,-87,140800,140500,5444,116356,133756,OK
41.009479,delay,Tick,283,196,87,-87,140800,140700,5444,116356,125056,OK
41.25686,delay,Tick,283,196,87,-87,140800,140500,5444,116356,133756,OK
41.474896,delay,Tick,283,196,87,-87,140800,140500,5444,116356,133756,OK
41.788032,delay,Tick,283,196,87,-87,140800,140500,5444,116356,133756,OK
41.996404,delay,Tick,283,196,87,-87,140800,140500,5444,116356,133756,OK
42.2602,delay,Tick,286,196,90,-90,139800,140500,5402,116998,98998,OK
42.451372,delay,Tick,286,196,90,-90,139800,140500,5402,116998,98998,OK
42.729879,delay,Tick,286,223,63,-63,140600,140500,5022,120078,126378,OK
42.954151,delay,Tick,286,223,63,-63,140600,140500,5022,120078,126378,OK
43.23424,delay,Tick,295,223,72,-72,140000,140400,4896,122904,108504,OK
43.541078,delay,Tick,296,223,73,-73,139800,140400,4882,123118,108518,OK
43.787012,delay,Tick,296,223,73,-73,139800,140400,4882,123118,108518,OK
44.048296,delay,Tick,296,223,73,-73,139800,140400,4882,123118,108518,OK
44.283192,delay,Tick,296,233,63,-63,141100,140400,4741,125259,137859,OK
44.466641,delay,Tick,296,233,63,-63,141100,140700,4741,125259,137859,OK
44.735655,delay,Tick,296,233,63,-63,141100,140700,4741,125259,137859,OK
45.030813,delay,Tick,296,233,63,-63,141100,140700,4741,125259,137859,OK
45.223871,delay,Tick,296,233,63,-63,141100,140700,4741,125259,137859,OK
45.493184,delay,Tick,296,237,59,-59,141200,140700,4685,126515,138315,OK
45.779631,delay,Tick,296,237,59,-59,141200,140700,4685,126515,138315,OK
46.020816,delay,Tick,296,237,59,-59,141200,140700,4685,126515,138315,OK
46.218062,delay,Tick,296,237,59,-59,141200,140700,4685,126515,138315,OK
46.471324,delay,Tick,296,237,59,-59,141200,140700,4685,126515,138315,OK
46.76066,delay,Tick,296,237,59,-59,141200,140700,4685,126515,138315,OK
47.020914,delay,Tick,296,237,59,-59,140800,140700,4685,126515,132415,OK
47.248161,delay,Tick,296,237,59,-59,141000,140700,4685,126515,138315,OK
47.489646,delay,Tick,296,237,59,-59,141000,140700,4685,126515,138315,OK
47.762384,delay,Tick,296,237,59,-59,141000,140700,4685,126515,138315,OK
47.978023,delay,Tick,296,237,59,-59,141000,140700,4685,126515,138315,OK
48.236267,delay,Tick,296,237,59,-59,140700,140700,4685,126515,126515,OK
48.491199,delay,Tick,306,237,69,-69,140200,140700,4545,128655,114855,OK
48.716072,delay,Tick,306,237,69,-69,140200,140700,4545,128655,114855,OK
48.953046,delay,Tick,306,237,69,-69,140200,140700,4545,128655,114855,OK
49.283902,delay,Tick,316,237,79,-79,140600,140700,4826,130374,122474,OK
49.490714,delay,Tick,316,237,79,-79,140600,140700,4826,130374,122474,OK
49.787898,delay,Tick,316,237,79,-79,140600,140700,4826,130374,122474,OK
50.018096,delay,Tick,316,237,79,-79,140600,140700,4826,130374,122474,OK
50.239446,delay,Tick,316,237,79,-79,140600,140700,4826,130374,122474,OK
50.490983,delay,Tick,316,237,79,-79,140600,140700,4826,130374,122474,OK
50.73484,delay,Tick,326,247,79,-79,141300,140700,4966,135234,151034,OK
51.007341,delay,Tick,326,247,79,-79,141300,140700,4966,135234,151034,OK
51.248097,delay,Tick,326,247,79,-79,141300,140700,4966,135234,151034,OK
51.481159,delay,Tick,326,247,79,-79,141300,140700,4966,135234,151034,OK
51.760699,delay,Tick,326,257,69,-69,141300,140700,4825,137375,151175,OK
51.958725,delay,Tick,326,257,69,-69,141300,140700,4825,137375,151175,OK
52.215327,delay,Tick,326,257,69,-69,141300,140700,4825,137375,151175,OK
52.45496,delay,Tick,326,257,69,-69,141300,140700,4825,137375,151175,OK
52.751696,delay,Tick,326,267,59,-59,141300,140700,4684,140516,152316,OK
52.991213,delay,Tick,326,277,49,-49,141100,140700,4543,142657,152457,OK
53.232361,delay,Tick,326,287,39,-39,141200,140700,4825,145375,153175,OK
53.506813,delay,Tick,326,297,29,-29,141200,140700,5107,147093,152893,OK
53.795829,delay,Tick,326,307,19,-19,141200,140700,5389,148811,152611,OK
53.992982,delay,Tick,326,317,9,-9,141200,140700,5671,150529,152329,OK
54.266995,delay,Tick,336,317,19,-19,140400,140700,5530,152670,148870,OK
54.477247,delay,Tick,336,317,19,-19,140400,140700,5530,152670,148870,OK
54.755947,delay,Tick,336,317,19,-19,140400,140700,5530,152670,148870,OK
54.979595,delay,Tick,336,317,19,-19,140400,140700,5530,152670,148870,OK
55.224731,delay,Tick,336,317,19,-19,140400,140700,5530,152670,148870,OK
55.483629,delay,Tick,336,317,19,-19,140400,141000,5530,152670,148870,OK
55.784029,delay,Tick,336,317,19,-19,140400,141000,5530,152670,148870,OK
56.000798,delay,Tick,336,317,19,-19,140400,141000,5530,152670,148870,OK
56.229429,delay,Tick,336,317,19,-19,140400,141000,5530,152670,148870,OK
56.497169,delay,Tick,336,317,19,-19,140400,141000,5530,152670,148870,OK
56.790807,delay,Tick,336,317,19,-19,140400,141000,5530,152670,148870,OK
56.979535,delay,Tick,336,317,19,-19,141400,141000,5530,152670,156470,OK
57.293669,delay,Tick,346,317,29,-29,140600,141000,5389,154811,149011,OK
57.514861,delay,Tick,346,318,28,-28,141400,141000,5375,155025,160625,OK
57.783171,delay,Tick,356,327,29,-29,141500,141000,5107,159193,164993,OK
58.028564,delay,Tick,356,327,29,-29,141500,141000,5107,159193,164993,OK
58.227174,delay,Tick,356,327,29,-29,141500,141000,5107,159193,164993,OK
58.455285,delay,Tick,356,327,29,-29,141500,141000,5107,159193,164993,OK
58.760019,delay,Tick,356,327,29,-29,141500,141000,5107,159193,164993,OK
58.989427,delay,Tick,356,327,29,-29,141500,140900,5107,159193,164993,OK
59.270379,delay,Tick,356,327,29,-29,141500,140900,5107,159193,164993,OK
59.500898,delay,Tick,356,327,29,-29,141500,141100,5107,159193,164993,OK
59.743492,delay,Tick,356,327,29,-29,141500,141100,5107,159193,164993,OK
59.976388,delay,Tick,356,332,24,-24,141200,141100,5036,160264,162664,OK
60.293159,delay,Tick,356,332,24,-24,141200,140800,5036,160264,165064,OK
60.543365,delay,Tick,356,342,14,-14,141400,140800,4895,162405,165205,OK
60.744021,delay,Tick,356,342,14,-14,141400,140800,4895,162405,165205,OK
61.036581,delay,Tick,356,342,14,-14,141400,140700,4895,162405,165205,OK
61.290689,delay,Tick,356,342,14,-14,141400,140700,4895,162405,165205,OK
61.548814,delay,Tick,356,342,14,-14,141400,140700,4895,162405,165205,OK
61.730013,delay,Tick,356,342,14,-14,141400,140700,4895,162405,165205,OK
61.995845,delay,Tick,356,342,14,-14,141400,140600,4895,162405,165205,OK
62.257337,delay,Tick,366,342,24,-24,140500,140600,4755,162545,160145,OK
62.488446,delay,Tick,366,342,24,-24,140500,140600,4755,162545,160145,OK
62.74883,delay,Tick,366,352,14,-14,141200,140600,4614,164686,167486,OK
62.95383,delay,Tick,366,352,14,-14,141200,140600,4614,164686,167486,OK
63.252546,delay,Tick,366,362,4,-4,141200,140500,4473,166827,167627,OK
63.524962,delay,Tick,366,362,4,-4,141200,140500,4473,166827,167627,OK
63.730766,delay,Tick,366,362,4,-4,141200,140500,4473,166827,167627,OK
64.010547,delay,Tick,366,372,-6,6,141200,140500,4332,168968,167768,OK
64.215336,delay,Tick,366,382,-16,16,141200,140500,4191,172109,168909,OK
64.497006,delay,Tick,366,382,-16,16,140300,140500,4191,172109,175309,OK
64.773465,delay,Tick,376,382,-6,6,140100,140500,4051,174249,175449,OK
65.050426,delay,Tick,386,382,4,-4,140100,140500,4331,176969,176169,OK
65.245589,delay,Tick,396,382,14,-14,140100,140400,4611,179689,176889,OK
65.485608,delay,Tick,406,382,24,-24,140100,140400,4891,181409,176609,OK
65.731601,delay,Tick,416,382,34,-34,140100,140400,5171,183129,176329,OK
65.984102,delay,Tick,419,382,37,-37,140100,140400,5255,183945,176545,OK
66.254554,delay,Tick,419,382,37,-37,140100,140400,5255,183945,176545,OK
66.530283,delay,Tick,419,382,37,-37,140500,140400,5255,183945,187645,OK
66.710868,delay,Tick,419,382,37,-37,140500,140400,5255,183945,187645,OK
67.025399,delay,Tick,419,382,37,-37,140500,140400,5255,183945,187645,OK
67.265628,delay,Tick,419,392,27,-37,140700,140400,5115,1589085,190485,OK
67.482495,delay,Tick,419,392,27,-27,140700,140400,5115,187085,192485,OK
67.769903,delay,Tick,419,392,27,-27,139900,140400,5115,187085,181685,OK
67.998226,delay,Tick,419,392,27,-27,139900,140400,5115,187085,181685,OK
68.278974,delay,Tick,419,392,27,-27,139900,140400,5115,187085,181685,OK
68.493728,delay,Tick,419,392,27,-27,139900,140400,5115,187085,181685,OK
68.760626,delay,Tick,419,392,27,-27,139900,140400,5115,187085,181685,OK
68.988411,delay,Tick,419,392,27,-27,139900,140400,5115,187085,181685,OK
69.297562,delay,Tick,419,392,27,-27,139900,140000,5115,187085,184385,OK
69.474692,delay,Tick,419,392,27,-27,139900,140000,5115,187085,184385,OK
69.74157,delay,Tick,419,392,27,-27,139900,140000,5115,187085,184385,OK
70.042817,delay,Tick,419,392,27,-27,139900,140000,5115,187085,184385,OK
70.276546,delay,Tick,419,392,27,-27,139900,140000,5115,187085,184385,OK
70.483691,delay,Tick,419,392,27,-27,139900,140000,5115,187085,184385,OK
70.792293,delay,Tick,419,392,27,-27,139900,140000,5115,187085,184385,OK
70.99303,delay,Tick,419,392,27,-27,139900,140000,5115,187085,184385,OK
71.229562,delay,Tick,419,392,27,-27,139900,140000,5115,187085,184385,OK
71.457099,delay,Tick,419,392,27,-27,139900,140000,5115,187085,184385,OK
71.781215,delay,Tick,419,392,27,-27,139900,140000,5115,187085,184385,OK
71.980559,delay,Tick,429,392,37,-37,140200,140000,5395,189805,197205,OK
72.202629,delay,Tick,439,392,47,-47,140200,140000,5675,193525,202925,OK
72.517064,delay,Tick,439,392,47,-47,140200,140000,5675,193525,202925,OK
72.790579,delay,Tick,439,392,47,-47,140500,140000,5675,193525,202925,OK
73.046975,delay,Tick,439,392,47,-47,140500,140700,5675,193525,184125,OK
73.227993,delay,Tick,439,402,37,-37,141100,140700,5534,196666,204066,OK
73.506794,delay,Tick,439,402,37,-37,141100,140700,5534,196666,204066,OK
73.737552,delay,Tick,439,412,27,-27,140800,140400,5816,200384,205784,OK
74.004822,delay,Tick,439,422,17,-17,140800,140400,6098,203102,206502,OK
74.292439,delay,Tick,439,432,7,-7,140800,140400,6380,205820,207220,OK
74.537936,delay,Tick,449,442,7,-7,139900,140400,6522,210678,209278,OK
74.710757,delay,Tick,459,442,17,-17,140000,140400,6382,212818,209418,OK
75.022794,delay,Tick,459,442,17,-17,140000,140400,6382,212818,209418,OK
75.214278,delay,Tick,459,442,17,-17,140000,140400,6382,212818,209418,OK
75.544737,delay,Tick,459,442,17,-17,140000,140400,6382,212818,209418,OK
75.711522,delay,Tick,459,442,17,-17,140000,140400,6382,212818,209418,OK
76.028959,delay,Tick,459,452,7,-7,141100,140400,6241,214959,216359,OK
76.249034,delay,Tick,459,452,7,-7,141100,140700,6241,214959,216359,OK
76.523899,delay,Tick,469,452,17,-17,140000,140700,6101,217099,213699,OK
76.720242,delay,Tick,469,452,17,-17,140000,140700,6101,217099,213699,OK
76.958374,delay,Tick,469,452,17,-17,140000,140700,6101,217099,213699,OK
77.263587,delay,Tick,469,452,17,-17,140000,140700,6101,217099,213699,OK
77.479745,delay,Tick,469,452,17,-17,140000,140700,6101,217099,213699,OK
77.733415,delay,Tick,469,452,17,-17,141200,140700,6101,217099,220499,OK
77.951777,delay,Tick,469,452,17,-17,141200,140700,6101,217099,220499,OK
78.201832,delay,Tick,479,452,27,-27,140900,141500,5960,220240,214840,OK
78.55116,delay,Tick,489,452,37,-37,140900,141500,6242,224958,217558,OK
78.756231,delay,Tick,499,452,47,-47,141300,141700,6525,227675,218275,OK
78.962375,delay,Tick,509,452,57,-57,141300,141700,6808,230392,218992,OK
79.216265,delay,Tick,519,452,67,-67,141200,141700,7091,233109,219709,OK
79.522624,delay,Tick,529,452,77,-77,141300,141700,7374,235826,220426,OK
79.772698,delay,Tick,539,452,87,-87,141300,141700,7657,238543,221143,OK
80.014488,delay,Tick,542,452,90,-90,141500,142000,7742,239958,221958,OK
80.237709,delay,Tick,542,452,90,-90,141500,142000,7742,239958,221958,OK
80.477194,delay,Tick,542,452,90,-90,141600,142000,7742,239958,221958,OK
80.719202,delay,Tick,542,452,90,-90,141600,142000,7742,239958,221958,OK
80.983244,delay,Tick,542,452,90,-90,141600,142000,7742,239958,221958,OK
81.221248,delay,Tick,542,452,90,-90,141800,142000,7742,239958,221958,OK
81.459217,delay,Tick,542,452,90,-90,141800,142000,7742,239958,221958,OK
81.771848,delay,Tick,542,452,90,-90,141800,142000,7742,239958,221958,OK
82.004925,delay,Tick,542,452,90,-90,141800,142000,7742,239958,221958,OK
82.261914,delay,Tick,542,452,90,-90,141800,142000,7742,239958,221958,OK
82.489016,delay,Tick,542,452,90,-90,141800,142000,7742,239958,221958,OK
82.746141,delay,Tick,542,452,90,-90,141800,142000,7742,239958,221958,OK
82.985056,delay,Tick,542,452,90,-90,141800,142000,7742,239958,221958,OK
83.263052,delay,Tick,542,452,90,-90,141800,142000,7742,239958,221958,OK
83.543791,delay,Tick,542,452,90,-90,141800,142000,7742,239958,221958,OK
83.777116,delay,Tick,542,452,90,-90,141800,142300,7742,239958,221958,OK
83.992496,delay,Tick,542,452,90,-90,141800,142300,7742,239958,221958,OK
84.281652,delay,Tick,542,452,90,-90,141800,142200,7742,239958,221958,OK
84.525017,delay,Tick,542,452,90,-90,141800,142200,7742,239958,221958,OK
84.75929,delay,Tick,542,452,90,-90,141800,142400,7742,239958,221958,OK
85.023605,delay,Tick,542,452,90,-90,141800,142400,7742,239958,221958,OK
85.283605,delay,Tick,542,452,90,-90,142000,142400,7742,239958,221958,OK
85.515836,delay,Tick,542,452,90,-90,142000,142400,7742,239958,221958,OK
85.748345,delay,Tick,542,452,90,-90,142100,142400,7742,239958,221958,OK
86.031492,delay,Tick,542,452,90,-90,142100,142400,7742,239958,221958,OK
86.204003,delay,Tick,542,452,90,-90,142100,142700,7742,239958,221958,OK
86.46651,delay,Tick,542,452,90,-90,142100,142700,7742,239958,221958,OK
86.748207,delay,Tick,542,452,90,-90,142100,142700,7742,239958,221958,OK
87.000938,delay,Tick,542,452,90,-90,142300,142700,7742,239958,221958,OK
87.242906,delay,Tick,542,452,90,-90,142300,142700,7742,239958,221958,OK
87.542616,delay,Tick,542,452,90,-90,141800,142700,7742,239958,221958,OK
87.78429,delay,Tick,542,452,90,-90,141800,142400,7742,239958,221958,OK
88.038634,delay,Tick,542,452,90,-90,141800,142400,7742,239958,221958,OK
88.297636,delay,Tick,542,452,90,-90,141800,142400,7742,239958,221958,OK
88.494949,delay,Tick,542,452,90,-90,141800,142400,7742,239958,221958,OK
88.788524,delay,Tick,542,452,90,-90,141800,142400,7742,239958,221958,OK
89.018839,delay,Tick,542,452,90,-90,142300,142200,7742,239958,248958,OK
89.275846,delay,Tick,542,452,90,-90,142300,142200,7742,239958,248958,OK
89.493324,delay,Tick,542,452,90,-90,142300,142200,7742,239958,248958,OK
89.732552,delay,Tick,542,452,90,-90,142300,142200,7742,239958,248958,OK
90.026875,delay,Tick,542,452,90,-90,142300,142200,7742,239958,248958,OK
90.246452,delay,Tick,542,452,90,-90,142300,142200,7742,239958,248958,OK
90.462217,delay,Tick,542,452,90,-90,142300,142200,7742,239958,248958,OK
90.716708,delay,Tick,542,452,90,-90,142300,142200,7742,239958,248958,OK
90.985164,delay,Tick,542,452,90,-90,142300,142200,7742,239958,248958,OK
91.219526,delay,Tick,542,452,90,-90,142300,142200,7742,239958,248958,OK
91.533384,delay,Tick,542,452,90,-90,142300,142200,7742,239958,248958,OK
91.710394,delay,Tick,542,452,90,-90,142300,142200,7742,239958,248958,OK
92.038172,delay,Tick,542,452,90,-90,142300,141700,7742,239958,257958,OK
92.282986,delay,Tick,542,452,90,-90,142300,141700,7742,239958,257958,OK
92.498027,delay,Tick,542,452,90,-90,141500,141700,7742,239958,221958,OK
92.750991,delay,Tick,542,452,90,-90,141500,141700,7742,239958,221958,OK
92.956264,delay,Tick,542,452,90,-90,141500,141700,7742,239958,221958,OK
93.215663,delay,Tick,542,452,90,-90,141500,141700,7742,239958,221958,OK
93.472921,delay,Tick,542,452,90,-90,141500,141700,7742,239958,221958,OK
93.768817,delay,Tick,542,452,90,-90,141500,141700,7742,239958,221958,OK
93.984301,delay,Tick,542,452,90,-90,141500,141700,7742,239958,221958,OK
94.206388,delay,Tick,542,484,58,-58,142100,141700,7287,246813,258413,OK
94.471807,delay,Tick,542,484,58,-58,141500,141700,7287,246813,235213,OK
94.801027,delay,Tick,552,484,68,-68,141500,141700,7570,248530,234930,OK
95.022364,delay,Tick,562,484,78,-78,141500,141700,7853,250247,234647,OK
95.282463,delay,Tick,572,484,88,-88,141500,141700,8136,251964,234364,OK
95.52259,delay,Tick,572,484,88,-88,141500,141700,8136,251964,234364,OK
95.767299,delay,Tick,574,484,90,-90,141500,141900,8193,252307,234307,OK
95.988405,delay,Tick,574,484,90,-90,141500,141900,8193,252307,234307,OK
96.266013,delay,Tick,574,484,90,-90,141500,142100,8193,252307,234307,OK
96.469073,delay,Tick,574,484,90,-90,141500,142100,8193,252307,234307,OK
96.722514,delay,Tick,574,484,90,-90,141500,142200,8193,252307,234307,OK
96.955991,delay,Tick,574,484,90,-90,141500,142200,8193,252307,234307,OK
97.239916,delay,Tick,574,484,90,-90,141500,142200,8193,252307,234307,OK
97.470382,delay,Tick,574,484,90,-90,141500,142200,8193,252307,234307,OK
97.774779,delay,Tick,574,484,90,-90,141500,142300,8193,252307,234307,OK
98.007128,delay,Tick,574,484,90,-90,141500,142300,8193,252307,234307,OK
98.213802,delay,Tick,574,484,90,-90,141500,142300,8193,252307,234307,OK
98.533573,delay,Tick,574,484,90,-90,141500,142300,8193,252307,234307,OK
98.782422,delay,Tick,574,484,90,-90,141500,142300,8193,252307,234307,OK
98.986684,delay,Tick,574,484,90,-90,141500,142300,8193,252307,234307,OK
99.266516,delay,Tick,574,484,90,-90,141500,142300,8193,252307,234307,OK
99.546146,delay,Tick,574,484,90,-90,141500,142300,8193,252307,234307,OK
99.785992,delay,Tick,574,484,90,-90,141500,142300,8193,252307,234307,OK
99.994053,delay,Tick,574,484,90,-90,141500,142300,8193,252307,234307,OK
100.209252,delay,Tick,574,484,90,-90,141500,142300,8193,252307,234307,OK
100.504934,delay,Tick,574,484,90,-90,141500,142100,8193,252307,234307,OK
100.797577,delay,Tick,574,542,32,-32,142200,142100,8691,263409,266609,OK
100.953691,delay,Tick,574,542,32,-32,142200,142100,8691,263409,266609,OK
101.266158,delay,Tick,574,552,22,-22,142800,142100,8548,266552,270952,OK
101.503241,delay,Tick,574,552,22,-22,142800,142100,8548,266552,270952,OK
101.745298,delay,Tick,574,562,12,-12,142700,142100,8406,268694,271094,OK
102.038519,delay,Tick,574,562,12,-12,142700,142100,8406,268694,271094,OK
102.297828,delay,Tick,574,562,12,-12,142700,142100,8406,268694,271094,OK
102.526067,delay,Tick,574,572,2,-2,142800,142100,8264,270836,271236,OK
102.774036,delay,Tick,574,582,-8,8,142800,142100,8122,271978,270378,OK
102.955452,delay,Tick,574,582,-8,8,142800,142100,8122,271978,270378,OK
103.280937,delay,Tick,574,582,-8,8,142800,142100,8122,271978,270378,OK
103.474668,delay,Tick,574,582,-8,8,142800,142100,8122,271978,270378,OK
103.78803,delay,Tick,574,582,-8,8,142800,142100,8122,271978,270378,OK
104.014855,delay,Tick,574,582,-8,8,142800,142100,8122,271978,270378,OK
104.247567,delay,Tick,574,582,-8,8,142800,142100,8122,271978,270378,OK
104.495976,delay,Tick,581,582,-1,1,141800,142100,8023,272777,272977,OK
104.738423,delay,Tick,581,582,-1,1,141800,142100,8023,272777,272977,OK
105.008139,delay,Tick,581,582,-1,1,141800,142100,8023,272777,272977,OK
105.290264,delay,Tick,581,582,-1,1,141800,141900,8023,272777,272877,OK
105.458452,delay,Tick,581,592,-11,11,142500,141800,7881,275919,273719,OK
105.73491,delay,Tick,581,592,-11,11,142500,141800,7881,275919,273719,OK
106.052005,delay,Tick,581,602,-21,21,142400,141800,7739,278061,273861,OK
106.298825,delay,Tick,581,602,-21,21,142000,141800,7739,278061,273861,OK
106.539066,delay,Tick,581,602,-21,21,142000,141800,7739,278061,273861,OK
106.717335,delay,Tick,581,602,-21,21,142000,141800,7739,278061,273861,OK
106.998016,delay,Tick,581,607,-26,26,142000,141800,7881,279419,274219,OK
107.208942,delay,Tick,581,607,-26,26,142000,141800,7881,279419,274219,OK
107.459802,delay,Tick,581,607,-26,26,142000,141800,7881,279419,274219,OK
107.791441,delay,Tick,581,607,-26,26,142000,141800,7881,279419,274219,OK
107.956862,delay,Tick,581,607,-26,26,142000,141800,7881,279419,274219,OK
108.235478,delay,Tick,581,627,-46,46,142000,141800,8023,283277,274077,OK
108.514603,delay,Tick,581,637,-56,56,142000,141800,8307,286993,275793,OK
108.729376,delay,Tick,581,647,-66,66,141600,141800,8590,288710,301910,OK
109.003438,delay,Tick,581,653,-72,72,141600,141200,8760,289740,275340,OK
109.286026,delay,Tick,581,653,-72,72,141600,141400,8760,289740,275340,OK
109.521189,delay,Tick,581,653,-72,72,141600,141400,8760,289740,275340,OK
109.789372,delay,Tick,581,653,-72,72,141500,141400,8760,289740,282540,OK
109.965091,delay,Tick,581,653,-72,72,141500,141400,8760,289740,282540,OK
110.216366,delay,Tick,581,653,-72,72,141500,141400,8760,289740,282540,OK
110.47337,delay,Tick,581,653,-72,72,141500,141400,8760,289740,282540,OK
110.771446,delay,Tick,581,655,-74,74,141500,141400,8817,290083,282683,OK
110.988163,delay,Tick,581,655,-74,74,141500,141400,8817,290083,282683,OK
111.282694,delay,Tick,581,665,-84,84,141400,141400,9100,291800,291800,OK
111.468225,delay,Tick,581,671,-90,90,141400,141400,9270,292830,292830,OK
111.703625,delay,Tick,581,671,-90,90,141400,141400,9270,292830,292830,OK
112.036894,delay,Tick,581,671,-90,90,141400,141400,9270,292830,292830,OK
112.280031,delay,Tick,581,671,-90,90,141400,141400,9270,292830,292830,OK
112.498758,delay,Tick,581,671,-90,90,141400,141400,9270,292830,292830,OK
112.789188,delay,Tick,581,671,-90,90,141400,141400,9270,292830,292830,OK
113.00909,delay,Tick,581,671,-90,90,141400,141400,9270,292830,292830,OK
113.27146,delay,Tick,581,671,-90,90,141400,141400,9270,292830,292830,OK
113.464882,delay,Tick,581,671,-90,90,141400,141200,9270,292830,274830,OK
113.723691,delay,Tick,581,671,-90,90,141400,141200,9270,292830,274830,OK
113.986444,delay,Tick,581,671,-90,90,141800,141200,9270,292830,274830,OK
114.293669,delay,Tick,581,671,-90,90,141800,141000,9270,292830,274830,OK
114.474243,delay,Tick,581,671,-90,90,141400,141000,9270,292830,274830,OK
114.739338,delay,Tick,581,671,-90,90,141400,141000,9270,292830,274830,OK
115.006364,delay,Tick,581,671,-90,90,141400,141000,9270,292830,274830,OK
115.236083,delay,Tick,581,671,-90,90,141300,141000,9270,292830,274830,OK
115.484425,delay,Tick,581,671,-90,90,141300,141000,9270,292830,274830,OK
115.729454,delay,Tick,581,671,-90,90,141300,141000,9270,292830,274830,OK
116.049218,delay,Tick,581,671,-90,90,141300,141000,9270,292830,274830,OK
116.215522,delay,Tick,581,671,-90,90,141300,141000,9270,292830,274830,OK
116.544978,delay,Tick,581,671,-90,90,141300,141000,9270,292830,274830,OK
116.797171,delay,Tick,581,671,-90,90,141300,141000,9270,292830,274830,OK
117.041669,delay,Tick,581,671,-90,90,141300,141000,9270,292830,274830,OK
117.261686,delay,Tick,581,671,-90,90,141300,141000,9270,292830,274830,OK
117.474357,delay,Tick,581,671,-90,90,141300,141000,9270,292830,274830,OK
117.753305,delay,Tick,581,671,-90,90,141800,141000,9270,292830,274830,OK
118.007746,delay,Tick,581,671,-90,90,141800,141000,9270,292830,274830,OK
118.229847,delay,Tick,581,671,-90,90,141300,141300,9270,292830,292830,OK
118.48717,delay,Tick,581,671,-90,90,141300,141300,9270,292830,292830,OK
118.765207,delay,Tick,581,671,-90,90,141300,141300,9270,292830,292830,OK
118.99332,delay,Tick,581,671,-90,90,141300,141300,9270,292830,292830,OK
119.285096,delay,Tick,581,671,-90,90,141300,141100,9270,292830,274830,OK
119.486381,delay,Tick,581,671,-90,90,141600,141100,9270,292830,274830,OK
119.780314,delay,Tick,581,671,-90,90,141600,141100,9270,292830,274830,OK
120.036307,delay,Tick,581,671,-90,90,141500,141100,9270,292830,274830,OK
120.22475,delay,Tick,581,671,-90,90,141500,141100,9270,292830,274830,OK
120.47708,delay,Tick,581,671,-90,90,141000,141100,9270,292830,301830,OK
120.790444,delay,Tick,581,671,-90,90,141000,141100,9270,292830,301830,OK
120.977989,delay,Tick,581,671,-90,90,141000,141100,9270,292830,301830,OK
121.263484,delay,Tick,581,671,-90,90,141000,141100,9270,292830,301830,OK
121.525426,delay,Tick,581,671,-90,90,141000,141100,9270,292830,301830,OK
121.789745,delay,Tick,581,671,-90,90,141300,141100,9270,292830,274830,OK
122.009832,delay,Tick,581,671,-90,90,141300,141100,9270,292830,274830,OK
122.267119,delay,Tick,581,671,-90,90,141300,140600,9270,292830,274830,OK
122.52537,delay,Tick,581,671,-90,90,141200,140600,9270,292830,274830,OK
122.758757,delay,Tick,581,671,-90,90,141200,140600,9270,292830,274830,OK
122.977401,delay,Tick,581,671,-90,90,141000,140600,9270,292830,274830,OK
123.219075,delay,Tick,581,671,-90,90,141000,140600,9270,292830,274830,OK
123.540626,delay,Tick,581,671,-90,90,141000,140400,9270,292830,274830,OK
123.78218,delay,Tick,581,671,-90,90,140700,140400,9270,292830,274830,OK
124.002421,delay,Tick,581,671,-90,90,140700,140400,9270,292830,274830,OK
124.29474,delay,Tick,581,671,-90,90,140600,140400,9270,292830,274830,OK
124.515425,delay,Tick,581,671,-90,90,140600,140400,9270,292830,274830,OK
124.792526,delay,Tick,581,671,-90,90,140600,140100,9270,292830,274830,OK
125.00208,delay,Tick,581,671,-90,90,140600,140000,9270,292830,274830,OK
125.2082,delay,Tick,581,671,-90,90,140500,140000,9270,292830,274830,OK
125.476902,delay,Tick,581,671,-90,90,140400,140000,9270,292830,274830,OK
125.762804,delay,Tick,581,671,-90,90,140400,140000,9270,292830,274830,OK
125.954158,delay,Tick,581,671,-90,90,140400,140000,9270,292830,274830,OK
126.240922,delay,Tick,581,671,-90,90,140400,140000,9270,292830,274830,OK
126.508092,delay,Tick,581,671,-90,90,140500,140000,9270,292830,274830,OK
126.746759,delay,Tick,581,671,-90,90,140200,140000,9270,292830,274830,OK
127.015033,delay,Tick,581,671,-90,90,140200,140000,9270,292830,274830,OK
127.262247,delay,Tick,581,671,-90,90,140200,140000,9270,292830,274830,OK
127.460497,delay,Tick,581,671,-90,90,140600,140100,9270,292830,274830,OK
127.756315,delay,Tick,581,671,-90,90,140600,140100,9270,292830,274830,OK
128.00698,delay,Tick,581,671,-90,90,140600,140100,9270,292830,274830,OK
128.208137,delay,Tick,581,671,-90,90,140200,140100,9270,292830,283830,OK
128.454158,delay,Tick,581,671,-90,90,140200,140100,9270,292830,283830,OK
128.714371,delay,Tick,581,671,-90,90,140200,140100,9270,292830,283830,OK
129.042415,delay,Tick,581,671,-90,90,140200,140100,9270,292830,283830,OK
129.259343,delay,Tick,581,671,-90,90,140200,140100,9270,292830,283830,OK
129.489455,delay,Tick,581,671,-90,90,140200,140100,9270,292830,283830,OK
129.724692,delay,Tick,581,671,-90,90,140200,140100,9270,292830,283830,OK
130.006851,delay,Tick,581,671,-90,90,140200,140100,9270,292830,283830,OK
130.282222,delay,Tick,581,671,-90,90,140200,140100,9270,292830,283830,OK
130.530254,delay,Tick,581,671,-90,90,140500,140100,9270,292830,274830,OK
130.772919,delay,Tick,581,671,-90,90,140500,140100,9270,292830,274830,OK
131.026581,delay,Tick,581,671,-90,90,140500,140000,9270,292830,274830,OK
131.236805,delay,Tick,581,671,-90,90,140500,140000,9270,292830,274830,OK
131.543011,delay,Tick,581,671,-90,90,140600,140000,9270,292830,274830,OK
131.775558,delay,Tick,581,671,-90,90,140600,140000,9270,292830,274830,OK
131.987076,delay,Tick,581,671,-90,90,140200,140000,9270,292830,274830,OK
132.245541,delay,Tick,581,671,-90,90,140200,140000,9270,292830,274830,OK
132.534866,delay,Tick,581,671,-90,90,140200,140000,9270,292830,274830,OK
132.735287,delay,Tick,581,671,-90,90,140200,140000,9270,292830,274830,OK
133.024312,delay,Tick,581,671,-90,90,140200,140000,9270,292830,274830,OK
133.285205,delay,Tick,581,671,-90,90,140200,139800,9270,292830,274830,OK
133.522775,delay,Tick,581,671,-90,90,140200,139800,9270,292830,274830,OK
133.746129,delay,Tick,581,671,-90,90,140200,139800,9270,292830,274830,OK
133.955496,delay,Tick,581,671,-90,90,140200,139900,9270,292830,274830,OK
134.212424,delay,Tick,581,671,-90,90,140200,139900,9270,292830,274830,OK
134.538697,delay,Tick,581,671,-90,90,140200,139900,9270,292830,274830,OK
134.726082,delay,Tick,581,671,-90,90,140200,140000,9270,292830,274830,OK
134.96638,delay,Tick,581,671,-90,90,140200,140000,9270,292830,274830,OK
135.211315,delay,Tick,581,671,-90,90,140200,140000,9270,292830,274830,OK
135.549103,delay,Tick,581,671,-90,90,140200,140000,9270,292830,274830,OK
135.737069,delay,Tick,581,671,-90,90,140200,140000,9270,292830,274830,OK
136.043283,delay,Tick,581,671,-90,90,140200,140000,9270,292830,274830,OK
136.22426,delay,Tick,581,671,-90,90,140200,140000,9270,292830,274830,OK
136.481859,delay,Tick,581,671,-90,90,140100,140100,9270,292830,292830,OK
136.747274,delay,Tick,581,671,-90,90,140100,140100,9270,292830,292830,OK
137.046846,delay,Tick,581,671,-90,90,140100,140100,9270,292830,292830,OK
137.203185,delay,Tick,581,671,-90,90,140100,140100,9270,292830,292830,OK
137.514072,delay,Tick,581,671,-90,90,140100,140100,9270,292830,292830,OK
137.735659,delay,Tick,581,671,-90,90,140100,140100,9270,292830,292830,OK
138.028818,delay,Tick,581,671,-90,90,140100,140100,9270,292830,292830,OK
138.229709,delay,Tick,581,671,-90,90,140100,140100,9270,292830,292830,OK
138.532688,delay,Tick,581,671,-90,90,140100,140100,9270,292830,292830,OK
138.734682,delay,Tick,581,671,-90,90,140100,140100,9270,292830,292830,OK
139.047688,delay,Tick,581,671,-90,90,140100,140100,9270,292830,292830,OK
139.267112,delay,Tick,581,671,-90,90,140100,139900,9270,292830,274830,OK
139.522265,delay,Tick,581,671,-90,90,140300,139900,9270,292830,274830,OK
139.758088,delay,Tick,581,671,-90,90,140300,139900,9270,292830,274830,OK
139.985931,delay,Tick,581,671,-90,90,140300,139900,9270,292830,274830,OK
140.246663,delay,Tick,581,671,-90,90,140300,139900,9270,292830,274830,OK
140.562741,delay,Tick,581,671,-90,90,140300,139900,9270,292830,274830,OK
140.702565,delay,Tick,581,671,-90,90,140300,139900,9270,292830,274830,OK
141.037612,delay,Tick,581,671,-90,90,140300,139900,9270,292830,274830,OK
141.258409,delay,Tick,581,671,-90,90,140000,139900,9270,292830,283830,OK
141.533659,delay,Tick,581,671,-90,90,140000,139900,9270,292830,283830,OK
141.763577,delay,Tick,581,671,-90,90,140000,139700,9270,292830,274830,OK
141.973415,delay,Tick,581,671,-90,90,140000,139700,9270,292830,274830,OK
142.211875,delay,Tick,581,671,-90,90,140000,139700,9270,292830,274830,OK
142.528933,delay,Tick,581,671,-90,90,140000,139700,9270,292830,274830,OK
142.712399,delay,Tick,581,671,-90,90,140000,139700,9270,292830,274830,OK
142.976671,delay,Tick,581,671,-90,90,140000,139700,9270,292830,274830,OK
143.214629,delay,Tick,581,671,-90,90,140000,139600,9270,292830,274830,OK
143.541416,delay,Tick,581,671,-90,90,140200,139600,9270,292830,274830,OK
143.701864,delay,Tick,581,671,-90,90,140200,139600,9270,292830,274830,OK
144.007688,delay,Tick,581,671,-90,90,140200,139700,9270,292830,274830,OK
144.222041,delay,Tick,581,671,-90,90,140200,139700,9270,292830,274830,OK
144.533782,delay,Tick,581,671,-90,90,140200,139800,9270,292830,274830,OK
144.733681,delay,Tick,581,671,-90,90,140200,139800,9270,292830,274830,OK
144.976379,delay,Tick,581,671,-90,90,139700,139800,9270,292830,301830,OK
145.260114,delay,Tick,581,671,-90,90,139700,139800,9270,292830,301830,OK
145.497403,delay,Tick,581,671,-90,90,139700,139700,9270,292830,292830,OK
145.793296,delay,Tick,581,671,-90,90,139700,139700,9270,292830,292830,OK
145.986428,delay,Tick,581,671,-90,90,139700,139900,9270,292830,310830,OK
146.204122,delay,Tick,581,671,-90,90,139700,139900,9270,292830,310830,OK
146.533784,delay,Tick,581,671,-90,90,139700,139800,9270,292830,301830,OK
146.778512,delay,Tick,581,671,-90,90,139700,139800,9270,292830,301830,OK
146.995023,delay,Tick,581,671,-90,90,140400,139800,9270,292830,274830,OK
147.284099,delay,Tick,581,671,-90,90,140400,139700,9270,292830,274830,OK
147.543784,delay,Tick,581,671,-90,90,139800,139700,9270,292830,283830,OK
147.754967,delay,Tick,581,671,-90,90,139800,139700,9270,292830,283830,OK
147.958507,delay,Tick,581,671,-90,90,139800,139700,9270,292830,283830,OK
148.232622,delay,Tick,581,671,-90,90,139800,139700,9270,292830,283830,OK
148.48272,delay,Tick,581,671,-90,90,139800,139700,9270,292830,283830,OK
148.740759,delay,Tick,581,671,-90,90,139800,139700,9270,292830,283830,OK
149.027915,delay,Tick,581,671,-90,90,139800,139900,9270,292830,301830,OK
149.296829,delay,Tick,581,671,-90,90,139800,139900,9270,292830,301830,OK
149.513156,delay,Tick,581,671,-90,90,139800,139800,9270,292830,292830,OK
149.74123,delay,Tick,581,671,-90,90,139800,139800,9270,292830,292830,OK
149.959628,delay,Tick,581,671,-90,90,139800,139800,9270,292830,292830,OK
150.237275,delay,Tick,581,671,-90,90,139800,139800,9270,292830,292830,OK
150.461389,delay,Tick,581,671,-90,90,139800,139800,9270,292830,292830,OK
150.731363,delay,Tick,581,671,-90,90,139800,139800,9270,292830,292830,OK
151.005024,delay,Tick,581,671,-90,90,139800,139800,9270,292830,292830,OK
151.240755,delay,Tick,581,671,-90,90,139800,139800,9270,292830,292830,OK
151.540987,delay,Tick,581,671,-90,90,139800,139800,9270,292830,292830,OK
151.730037,delay,Tick,581,671,-90,90,139800,139800,9270,292830,292830,OK
152.017312,delay,Tick,581,671,-90,90,139800,139800,9270,292830,292830,OK
152.234446,delay,Tick,581,671,-90,90,139800,139800,9270,292830,292830,OK
152.465747,delay,Tick,581,671,-90,90,139800,140100,9270,292830,310830,OK
152.701693,delay,Tick,581,671,-90,90,139800,140100,9270,292830,310830,OK
152.960657,delay,Tick,581,671,-90,90,139800,140100,9270,292830,310830,OK
153.263184,delay,Tick,581,671,-90,90,139800,140100,9270,292830,310830,OK
153.457938,delay,Tick,581,671,-90,90,139800,140100,9270,292830,310830,OK
153.729299,delay,Tick,581,671,-90,90,139800,140100,9270,292830,310830,OK
154.015023,delay,Tick,581,671,-90,90,139800,140100,9270,292830,310830,OK
154.265947,delay,Tick,581,671,-90,90,139700,140100,9270,292830,310830,OK
154.451607,delay,Tick,581,671,-90,90,139700,140100,9270,292830,310830,OK
154.733637,delay,Tick,581,671,-90,90,139700,140100,9270,292830,310830,OK
154.988846,delay,Tick,581,671,-90,90,139700,140100,9270,292830,310830,OK
155.278777,delay,Tick,581,671,-90,90,139700,140100,9270,292830,310830,OK
155.549077,delay,Tick,581,671,-90,90,139700,140100,9270,292830,310830,OK
155.725833,delay,Tick,581,671,-90,90,139700,139700,9270,292830,292830,OK
156.00381,delay,Tick,581,671,-90,90,139700,139700,9270,292830,292830,OK
156.254751,delay,Tick,581,671,-90,90,140100,139700,9270,292830,274830,OK
156.468442,delay,Tick,581,671,-90,90,140100,139700,9270,292830,274830,OK
156.78722,delay,Tick,581,671,-90,90,140100,139700,9270,292830,274830,OK
156.969731,delay,Tick,581,671,-90,90,140100,139700,9270,292830,274830,OK
157.204613,delay,Tick,581,671,-90,90,140100,139700,9270,292830,274830,OK
157.512983,delay,Tick,581,671,-90,90,140100,139700,9270,292830,274830,OK
157.709836,delay,Tick,581,671,-90,90,140100,139700,9270,292830,274830,OK
157.95596,delay,Tick,581,671,-90,90,140100,139700,9270,292830,274830,OK
158.286942,delay,Tick,581,671,-90,90,139700,139700,9270,292830,292830,OK
158.547733,delay,Tick,581,671,-90,90,140100,139700,9270,292830,274830,OK
158.71248,delay,Tick,581,671,-90,90,140100,139700,9270,292830,274830,OK
158.974885,delay,Tick,581,671,-90,90,139600,139700,9270,292830,301830,OK
159.226905,delay,Tick,581,671,-90,90,139600,139700,9270,292830,301830,OK
159.494228,delay,Tick,581,671,-90,90,139600,139700,9270,292830,301830,OK
159.73994,delay,Tick,581,671,-90,90,139600,139700,9270,292830,301830,OK
159.979641,delay,Tick,581,671,-90,90,139600,139700,9270,292830,301830,OK
160.215397,delay,Tick,581,671,-90,90,139600,139700,9270,292830,301830,OK
160.474577,delay,Tick,581,671,-90,90,139600,139700,9270,292830,301830,OK
160.767488,delay,Tick,581,671,-90,90,140100,139700,9270,292830,274830,OK
161.033142,delay,Tick,581,671,-90,90,140100,139700,9270,292830,274830,OK
161.211567,delay,Tick,581,671,-90,90,140100,139500,9270,292830,274830,OK
161.471452,delay,Tick,581,671,-90,90,140100,139500,9270,292830,274830,OK
161.772346,delay,Tick,581,671,-90,90,139400,139500,9270,292830,301830,OK
162.035711,delay,Tick,581,671,-90,90,139400,139500,9270,292830,301830,OK
162.235577,delay,Tick,581,671,-90,90,139400,139500,9270,292830,301830,OK
162.48379,delay,Tick,581,671,-90,90,139400,139500,9270,292830,301830,OK
162.707794,delay,Tick,581,671,-90,90,139400,139500,9270,292830,301830,OK
162.984172,delay,Tick,581,671,-90,90,139400,139500,9270,292830,301830,OK
163.262662,delay,Tick,581,671,-90,90,139400,139500,9270,292830,301830,OK
163.546963,delay,Tick,581,671,-90,90,139400,139500,9270,292830,301830,OK
163.714766,delay,Tick,581,671,-90,90,139400,139500,9270,292830,301830,OK
164.047754,delay,Tick,581,671,-90,90,139400,139500,9270,292830,301830,OK
164.260804,delay,Tick,581,671,-90,90,139400,139500,9270,292830,301830,OK
164.454594,delay,Tick,581,671,-90,90,139400,139500,9270,292830,301830,OK
164.78461,delay,Tick,581,671,-90,90,139400,139500,9270,292830,301830,OK
164.958437,delay,Tick,581,671,-90,90,139400,139500,9270,292830,301830,OK
165.237961,delay,Tick,581,671,-90,90,139400,139500,9270,292830,301830,OK
165.507281,delay,Tick,581,671,-90,90,139400,139600,9270,292830,310830,OK
165.779662,delay,Tick,581,671,-90,90,139400,139600,9270,292830,310830,OK
165.968777,delay,Tick,619,671,-52,52,139400,139600,8740,300960,311360,OK
166.229672,delay,Tick,619,671,-52,52,139400,139600,8740,300960,311360,OK
166.531633,delay,Tick,619,671,-52,52,139400,139600,8740,300960,311360,OK
166.75538,delay,Tick,619,671,-52,52,139400,139500,8740,300960,306160,OK
166.976832,delay,Tick,619,671,-52,52,139400,139600,8740,300960,311360,OK
167.274532,delay,Tick,619,671,-52,52,139400,139600,8740,300960,311360,OK
167.540497,delay,Tick,619,671,-52,52,139400,139600,8740,300960,311360,OK
167.751578,delay,Tick,619,671,-52,52,139400,139600,8740,300960,311360,OK
167.961927,delay,Tick,619,671,-52,52,139400,139600,8740,300960,311360,OK
168.213814,delay,Tick,629,671,-42,42,139300,139600,8600,303100,311500,OK
168.45627,delay,Tick,629,671,-42,42,139800,139600,8600,303100,294700,OK
168.7203,delay,Tick,629,671,-42,42,139800,139600,8600,303100,294700,OK
168.968009,delay,Tick,629,671,-42,42,139200,139600,8600,303100,311500,OK
169.23965,delay,Tick,629,671,-42,42,139200,139400,8600,303100,311500,OK
169.503754,delay,Tick,629,671,-42,42,139200,139400,8600,303100,311500,OK
169.739083,delay,Tick,629,671,-42,42,139200,139400,8600,303100,311500,OK
170.009436,delay,Tick,629,671,-42,42,139200,139400,8600,303100,311500,OK
170.243002,delay,Tick,629,671,-42,42,139200,139400,8600,303100,311500,OK
170.482111,delay,Tick,629,671,-42,42,139200,139500,8600,303100,311500,OK
170.733831,delay,Tick,629,671,-42,42,139200,139400,8600,303100,311500,OK
170.980122,delay,Tick,629,671,-42,42,139200,139400,8600,303100,311500,OK
171.229149,delay,Tick,632,671,-39,39,139200,139400,8558,303742,311542,OK
171.540483,delay,Tick,639,671,-32,32,139000,139400,8461,305239,311639,OK
171.72234,delay,Tick,639,671,-32,32,139000,139400,8461,305239,311639,OK
172.034952,delay,Tick,649,671,-22,22,139000,139400,8322,306378,310778,OK
172.220404,delay,Tick,649,671,-22,22,139000,139400,8322,306378,310778,OK
172.453837,delay,Tick,649,671,-22,22,139000,139400,8322,306378,310778,OK
172.701748,delay,Tick,649,671,-22,22,139000,139400,8322,306378,310778,OK
172.994802,delay,Tick,649,671,-22,22,139600,139400,8322,306378,301978,OK
173.267518,delay,Tick,649,671,-22,22,139600,139400,8322,306378,301978,OK
173.467645,delay,Tick,649,671,-22,22,139600,139400,8322,306378,301978,OK
173.779341,delay,Tick,649,671,-22,22,139800,139400,8322,306378,301978,OK
174.046516,delay,Tick,649,671,-22,22,139800,139400,8322,306378,301978,OK
174.238619,delay,Tick,649,671,-22,22,139800,139400,8322,306378,301978,OK
174.494706,delay,Tick,649,671,-22,22,139800,139400,8322,306378,301978,OK
174.782785,delay,Tick,649,681,-32,32,139900,139400,8182,308518,302118,OK
174.951342,delay,Tick,649,681,-32,32,139900,139400,8182,308518,302118,OK
175.213165,delay,Tick,649,681,-32,32,139900,139400,8182,308518,302118,OK
175.520008,delay,Tick,649,681,-32,32,139900,139400,8182,308518,302118,OK
175.748438,delay,Tick,649,681,-32,32,139900,139400,8182,308518,302118,OK
176.045546,delay,Tick,649,681,-32,32,139900,139400,8182,308518,302118,OK
176.263467,delay,Tick,649,681,-32,32,139900,139400,8182,308518,302118,OK
176.491165,delay,Tick,649,681,-32,32,139900,139400,8182,308518,302118,OK
176.721466,delay,Tick,649,681,-32,32,139900,139400,8182,308518,302118,OK
176.995296,delay,Tick,649,691,-42,42,140000,139400,8042,310658,302258,OK
177.288564,delay,Tick,649,691,-42,42,140000,139400,8042,310658,302258,OK
177.536106,delay,Tick,649,691,-42,42,139300,139400,8042,310658,314858,OK
177.795691,delay,Tick,649,691,-42,42,139300,139700,8042,310658,319058,OK
177.993644,delay,Tick,649,691,-42,42,139300,139700,8042,310658,319058,OK
178.218576,delay,Tick,649,691,-42,42,139300,139600,8042,310658,319058,OK
178.471162,delay,Tick,649,691,-42,42,139300,139600,8042,310658,319058,OK
178.731808,delay,Tick,649,691,-42,42,139300,139600,8042,310658,319058,OK
178.967954,delay,Tick,649,691,-42,42,139500,139400,8042,310658,306458,OK
179.22311,delay,Tick,649,691,-42,42,139500,139400,8042,310658,306458,OK
179.45741,delay,Tick,649,691,-42,42,139500,139400,8042,310658,306458,OK
179.760457,delay,Tick,649,691,-42,42,139500,139500,8042,310658,310658,OK
180.021184,delay,Tick,649,691,-42,42,139500,139400,8042,310658,306458,OK
180.246021,delay,Tick,649,691,-42,42,139500,139400,8042,310658,306458,OK
180.5111,delay,Tick,649,691,-42,42,139500,139400,8042,310658,306458,OK
180.743186,delay,Tick,649,691,-42,42,139500,139400,8042,310658,306458,OK
180.957982,delay,Tick,649,691,-42,42,139500,139400,8042,310658,306458,OK
181.247332,delay,Tick,649,691,-42,42,139500,139400,8042,310658,306458,OK
181.486635,delay,Tick,649,691,-42,42,139500,139400,8042,310658,306458,OK
181.753104,delay,Tick,649,691,-42,42,139500,139400,8042,310658,306458,OK
182.038141,delay,Tick,649,691,-42,42,139500,139200,8042,310658,302258,OK
182.230728,delay,Tick,649,691,-42,42,139500,138400,8042,310658,302258,OK
182.460851,delay,Tick,649,701,-52,52,139000,138500,8321,318379,307979,OK
182.701621,delay,Tick,649,711,-62,62,138900,138500,8599,321101,308701,OK
183.033673,delay,Tick,649,721,-72,72,138900,138500,8877,323823,309423,OK
183.223327,delay,Tick,649,731,-82,82,138900,138600,9155,326545,310145,OK
183.450822,delay,Tick,649,739,-90,90,138900,138600,9377,328723,310723,OK
183.718403,delay,Tick,649,739,-90,90,138900,138600,9377,328723,310723,OK
184.029652,delay,Tick,649,739,-90,90,138900,138600,9377,328723,310723,OK
184.236004,delay,Tick,649,739,-90,90,139200,138600,9377,328723,310723,OK
184.522723,delay,Tick,649,739,-90,90,138900,138700,9377,328723,310723,OK
184.739752,delay,Tick,649,739,-90,90,138900,138700,9377,328723,310723,OK
184.956502,delay,Tick,649,739,-90,90,138900,138900,9377,328723,328723,OK
185.28394,delay,Tick,649,739,-90,90,138900,138900,9377,328723,328723,OK
185.529495,delay,Tick,649,739,-90,90,138900,138900,9377,328723,328723,OK
185.733159,delay,Tick,649,739,-90,90,138900,138800,9377,328723,319723,OK
186.000141,delay,Tick,649,739,-90,90,138900,138800,9377,328723,319723,OK
186.269935,delay,Tick,649,739,-90,90,138900,138800,9377,328723,319723,OK
186.528331,delay,Tick,649,739,-90,90,138900,138500,9377,328723,310723,OK
186.785048,delay,Tick,649,739,-90,90,138900,138500,9377,328723,310723,OK
187.049152,delay,Tick,649,739,-90,90,138900,138400,9377,328723,310723,OK
187.282779,delay,Tick,649,739,-90,90,138900,138400,9377,328723,310723,OK
187.546342,delay,Tick,649,739,-90,90,138900,138500,9377,328723,310723,OK
187.740122,delay,Tick,649,739,-90,90,139000,138700,9377,328723,310723,OK
187.970742,delay,Tick,649,739,-90,90,139000,138800,9377,328723,310723,OK
188.266591,delay,Tick,649,739,-90,90,139500,139000,9377,328723,310723,OK
188.467748,delay,Tick,649,739,-90,90,139500,138900,9377,328723,310723,OK
188.757842,delay,Tick,649,739,-90,90,139500,138900,9377,328723,310723,OK
189.004601,delay,Tick,649,739,-90,90,139500,138900,9377,328723,310723,OK
189.208514,delay,Tick,649,739,-90,90,139500,138900,9377,328723,310723,OK
189.478347,delay,Tick,649,739,-90,90,139500,139000,9377,328723,310723,OK
189.707481,delay,Tick,649,739,-90,90,139500,138800,9377,328723,310723,OK
189.985571,delay,Tick,649,739,-90,90,138700,138000,9377,328723,310723,OK
190.282893,delay,Tick,649,739,-90,90,138500,137900,9377,328723,310723,OK
190.476766,delay,Tick,649,739,-90,90,138500,137900,9377,328723,310723,OK
190.740776,delay,Tick,649,739,-90,90,138500,137900,9377,328723,310723,OK
190.968694,delay,Tick,649,739,-90,90,138500,137900,9377,328723,310723,OK
191.260666,delay,Tick,649,739,-90,90,138400,137900,9377,328723,310723,OK
191.531538,delay,Tick,649,739,-90,90,138500,137900,9377,328723,310723,OK
191.760612,delay,Tick,649,739,-90,90,138500,137800,9377,328723,310723,OK
191.976684,delay,Tick,649,739,-90,90,138500,137900,9377,328723,310723,OK
192.238877,delay,Tick,649,739,-90,90,138500,137800,9377,328723,310723,OK
192.479137,delay,Tick,649,739,-90,90,138500,137800,9377,328723,310723,OK
192.798953,delay,Tick,649,739,-90,90,138500,137900,9377,328723,310723,OK
193.043138,delay,Tick,649,739,-90,90,138500,137900,9377,328723,310723,OK
193.205967,delay,Tick,649,739,-90,90,138400,137700,9377,328723,310723,OK
193.532505,delay,Tick,649,739,-90,90,138300,137800,9377,328723,310723,OK
193.712025,delay,Tick,649,739,-90,90,138300,137800,9377,328723,310723,OK
194.047902,delay,Tick,649,739,-90,90,138300,137700,9377,328723,310723,OK
194.295055,delay,Tick,649,739,-90,90,138200,137700,9377,328723,310723,OK
194.514177,delay,Tick,649,739,-90,90,138200,137700,9377,328723,310723,OK
194.778562,delay,Tick,649,739,-90,90,138200,137700,9377,328723,310723,OK
195.040018,delay,Tick,649,739,-90,90,138000,137300,9377,328723,310723,OK
195.265346,delay,Tick,649,739,-90,90,138000,137300,9377,328723,310723,OK
195.460783,delay,Tick,649,739,-90,90,138000,137300,9377,328723,310723,OK
195.710449,delay,Tick,649,739,-90,90,138000,137700,9377,328723,310723,OK
195.983754,delay,Tick,649,739,-90,90,138000,137700,9377,328723,310723,OK
196.203875,delay,Tick,649,739,-90,90,138000,137700,9377,328723,310723,OK
196.521041,delay,Tick,649,739,-90,90,138000,137700,9377,328723,310723,OK
196.75594,delay,Tick,649,739,-90,90,138000,137700,9377,328723,310723,OK
197.041731,delay,Tick,649,739,-90,90,138000,137800,9377,328723,310723,OK
197.201318,delay,Tick,649,739,-90,90,138000,137700,9377,328723,310723,OK
197.549996,delay,Tick,649,739,-90,90,138000,137700,9377,328723,310723,OK
197.745048,delay,Tick,649,739,-90,90,138000,137700,9377,328723,310723,OK
198.042183,delay,Tick,649,739,-90,90,137700,137500,9377,328723,310723,OK
198.205208,delay,Tick,649,739,-90,90,137700,137600,9377,328723,319723,OK
198.483891,delay,Tick,649,739,-90,90,138200,137600,9377,328723,310723,OK
198.722023,delay,Tick,649,739,-90,90,138200,137500,9377,328723,310723,OK
199.021427,delay,Tick,649,739,-90,90,138200,137500,9377,328723,310723,OK
199.259947,delay,Tick,649,739,-90,90,138200,137500,9377,328723,310723,OK
199.458617,delay,Tick,649,739,-90,90,138200,137500,9377,328723,310723,OK
199.771883,delay,Tick,649,739,-90,90,138200,137500,9377,328723,310723,OK
200.002355,delay,Tick,649,739,-90,90,138200,137500,9377,328723,310723,OK
200.258223,delay,Tick,649,739,-90,90,138200,137500,9377,328723,310723,OK
200.524892,delay,Tick,649,739,-90,90,138200,137500,9377,328723,310723,OK
200.786789,delay,Tick,649,739,-90,90,138200,137500,9377,328723,310723,OK
200.957413,delay,Tick,649,739,-90,90,137900,137500,9377,328723,310723,OK
201.22973,delay,Tick,649,739,-90,90,137900,137600,9377,328723,310723,OK
201.476582,delay,Tick,649,739,-90,90,137900,137900,9377,328723,328723,OK
201.712847,delay,Tick,649,739,-90,90,137900,137700,9377,328723,310723,OK
201.996487,delay,Tick,649,739,-90,90,137900,137700,9377,328723,310723,OK
202.214761,delay,Tick,649,739,-90,90,138000,137600,9377,328723,310723,OK
202.507957,delay,Tick,649,739,-90,90,138000,137600,9377,328723,310723,OK
202.784961,delay,Tick,649,739,-90,90,138000,137600,9377,328723,310723,OK
203.014514,delay,Tick,649,739,-90,90,138000,137600,9377,328723,310723,OK
203.248386,delay,Tick,649,739,-90,90,138000,137600,9377,328723,310723,OK
203.524449,delay,Tick,649,739,-90,90,138000,137500,9377,328723,310723,OK
203.753857,delay,Tick,649,739,-90,90,138000,137400,9377,328723,310723,OK
204.002237,delay,Tick,649,739,-90,90,137900,137400,9377,328723,310723,OK
204.275449,delay,Tick,649,739,-90,90,137900,137400,9377,328723,310723,OK
204.50961,delay,Tick,649,739,-90,90,137900,137400,9377,328723,310723,OK
204.78967,delay,Tick,649,739,-90,90,137600,137400,9377,328723,310723,OK
205.017835,delay,Tick,649,739,-90,90,137600,137400,9377,328723,310723,OK
205.246634,delay,Tick,649,739,-90,90,137600,137400,9377,328723,310723,OK
205.516252,delay,Tick,649,739,-90,90,137400,137400,9377,328723,328723,OK
205.79127,delay,Tick,649,739,-90,90,137400,137400,9377,328723,328723,OK
205.987749,delay,Tick,649,739,-90,90,137400,137400,9377,328723,328723,OK
206.265605,delay,Tick,649,739,-90,90,137400,137300,9377,328723,319723,OK
206.492486,delay,Tick,649,739,-90,90,137400,137300,9377,328723,319723,OK
206.717557,delay,Tick,649,739,-90,90,137400,137300,9377,328723,319723,OK
207.00511,delay,Tick,649,739,-90,90,138000,137400,9377,328723,310723,OK
207.299162,delay,Tick,649,739,-90,90,138000,137500,9377,328723,310723,OK
207.489466,delay,Tick,649,739,-90,90,138000,137500,9377,328723,310723,OK
207.735683,delay,Tick,649,739,-90,90,138000,137500,9377,328723,310723,OK
208.003015,delay,Tick,649,739,-90,90,138000,137500,9377,328723,310723,OK
208.28491,delay,Tick,649,739,-90,90,138000,137500,9377,328723,310723,OK
208.530765,delay,Tick,649,739,-90,90,137400,137700,9377,328723,346723,OK
208.789603,delay,Tick,649,739,-90,90,137400,137700,9377,328723,346723,OK
208.971914,delay,Tick,711,739,-28,28,137500,137700,8525,341975,347575,OK
209.24623,delay,Tick,711,739,-28,28,137500,137700,8525,341975,347575,OK
209.507905,delay,Tick,711,739,-28,28,137600,137700,8525,341975,344775,OK
209.71319,delay,Tick,711,739,-28,28,137600,137700,8525,341975,344775,OK
209.98464,delay,Tick,711,739,-28,28,137600,137700,8525,341975,344775,OK
210.227709,delay,Tick,711,739,-28,28,137600,137800,8525,341975,347575,OK
210.46081,delay,Tick,829,739,90,-90,137300,137800,6902,367198,349198,OK
210.745128,delay,Tick,829,739,90,-90,137300,137800,6902,367198,349198,OK
211.026535,delay,Tick,829,739,90,-90,137300,137800,6902,367198,349198,OK
211.230729,delay,Tick,829,739,90,-90,137600,138200,6902,367198,349198,OK
211.495373,delay,Tick,829,739,90,-90,137600,138100,6902,367198,349198,OK
211.743251,delay,Tick,829,739,90,-90,137600,138100,6902,367198,349198,OK
211.991045,delay,Tick,829,739,90,-90,137600,138100,6902,367198,349198,OK
212.228861,delay,Tick,829,739,90,-90,137600,138100,6902,367198,349198,OK
212.474805,delay,Tick,829,739,90,-90,137600,138100,6902,367198,349198,OK
212.739235,delay,Tick,829,739,90,-90,137600,138100,6902,367198,349198,OK
213.037592,delay,Tick,829,739,90,-90,137600,138100,6902,367198,349198,OK
213.284922,delay,Tick,829,739,90,-90,137600,138000,6902,367198,349198,OK
213.450667,delay,Tick,829,739,90,-90,137600,138000,6902,367198,349198,OK
213.735947,delay,Tick,829,739,90,-90,137600,138000,6902,367198,349198,OK
214.000182,delay,Tick,829,739,90,-90,137600,138000,6902,367198,349198,OK
214.23997,delay,Tick,829,739,90,-90,137600,138000,6902,367198,349198,OK
214.523454,delay,Tick,829,739,90,-90,137300,138000,6902,367198,349198,OK
214.728639,delay,Tick,829,739,90,-90,137300,138000,6902,367198,349198,OK
215.028623,delay,Tick,829,739,90,-90,137300,138000,6902,367198,349198,OK
215.262992,delay,Tick,829,739,90,-90,137300,138000,6902,367198,349198,OK
215.487282,delay,Tick,829,739,90,-90,137300,138000,6902,367198,349198,OK
215.72249,delay,Tick,829,739,90,-90,137500,138000,6902,367198,349198,OK
216.004697,delay,Tick,829,739,90,-90,137500,138000,6902,367198,349198,OK
216.292263,delay,Tick,829,739,90,-90,137500,138000,6902,367198,349198,OK
216.517961,delay,Tick,829,739,90,-90,137500,138000,6902,367198,349198,OK
216.739347,delay,Tick,829,739,90,-90,137500,138000,6902,367198,349198,OK
217.021401,delay,Tick,829,739,90,-90,137500,138000,6902,367198,349198,OK
217.28194,delay,Tick,829,739,90,-90,137500,138000,6902,367198,349198,OK
217.515758,delay,Tick,829,739,90,-90,137500,138000,6902,367198,349198,OK
217.707454,delay,Tick,829,739,90,-90,137500,138000,6902,367198,349198,OK
218.052094,delay,Tick,829,739,90,-90,137500,137700,6902,367198,349198,OK
218.221751,delay,Tick,829,739,90,-90,137500,137700,6902,367198,349198,OK
218.507422,delay,Tick,829,739,90,-90,137500,137600,6902,367198,358198,OK
218.793503,delay,Tick,829,739,90,-90,137100,137600,6902,367198,349198,OK
219.009863,delay,Tick,829,739,90,-90,137100,137600,6902,367198,349198,OK
219.2203,delay,Tick,829,739,90,-90,137100,137600,6902,367198,349198,OK
219.495122,delay,Tick,829,739,90,-90,137500,137600,6902,367198,358198,OK
219.742753,delay,Tick,829,739,90,-90,137500,137800,6902,367198,349198,OK
220.016784,delay,Tick,829,739,90,-90,137300,137800,6902,367198,349198,OK
220.271067,delay,Tick,829,739,90,-90,137300,137800,6902,367198,349198,OK
220.52358,delay,Tick,829,739,90,-90,137300,137800,6902,367198,349198,OK
220.714244,delay,Tick,829,739,90,-90,137300,138100,6902,367198,349198,OK
220.96876,delay,Tick,829,739,90,-90,137300,138100,6902,367198,349198,OK
221.298959,delay,Tick,829,739,90,-90,137300,138100,6902,367198,349198,OK
221.487324,delay,Tick,829,739,90,-90,137300,138100,6902,367198,349198,OK
221.784781,delay,Tick,829,739,90,-90,137500,138100,6902,367198,349198,OK
221.992857,delay,Tick,829,739,90,-90,137500,138100,6902,367198,349198,OK
222.216716,delay,Tick,829,739,90,-90,138100,138100,6902,367198,367198,OK
222.504623,delay,Tick,829,739,90,-90,138100,137800,6902,367198,385198,OK
222.768372,delay,Tick,829,739,90,-90,138100,137800,6902,367198,385198,OK
223.027706,delay,Tick,829,739,90,-90,138100,137800,6902,367198,385198,OK
223.254837,delay,Tick,829,739,90,-90,138100,137800,6902,367198,385198,OK
223.537606,delay,Tick,829,739,90,-90,138100,137800,6902,367198,385198,OK
223.711833,delay,Tick,829,739,90,-90,138100,137800,6902,367198,385198,OK
223.97697,delay,Tick,829,739,90,-90,137700,137800,6902,367198,358198,OK
224.214133,delay,Tick,829,739,90,-90,137700,137800,6902,367198,358198,OK
224.489336,delay,Tick,829,739,90,-90,137700,138000,6902,367198,349198,OK
224.741352,delay,Tick,829,739,90,-90,137700,138000,6902,367198,349198,OK
224.982103,delay,Tick,829,739,90,-90,137700,138000,6902,367198,349198,OK
225.234121,delay,Tick,829,739,90,-90,137700,138000,6902,367198,349198,OK
225.500313,delay,Tick,829,739,90,-90,137700,138000,6902,367198,349198,OK
225.771603,delay,Tick,829,739,90,-90,137700,138000,6902,367198,349198,OK
226.029935,delay,Tick,829,739,90,-90,138200,137700,6902,367198,385198,OK
226.222919,delay,Tick,829,739,90,-90,138200,137700,6902,367198,385198,OK
226.471091,delay,Tick,829,739,90,-90,138200,137700,6902,367198,385198,OK
226.751279,delay,Tick,829,739,90,-90,138200,137700,6902,367198,385198,OK
226.982171,delay,Tick,829,739,90,-90,138200,137700,6902,367198,385198,OK
227.290935,delay,Tick,829,830,-1,1,137900,137700,5648,381152,380952,OK
227.453793,delay,Tick,829,830,-1,1,137900,137700,5648,381152,380952,OK
227.79128,delay,Tick,829,830,-1,1,137900,137700,5648,381152,380952,OK
227.98449,delay,Tick,829,830,-1,1,137900,137700,5648,381152,380952,OK
228.24236,delay,Tick,829,830,-1,1,137900,137700,5648,381152,380952,OK
228.504652,delay,Tick,829,840,-11,11,138200,137500,5510,383290,381090,OK
228.756868,delay,Tick,829,850,-21,21,137700,137500,5785,386015,381815,OK
228.980691,delay,Tick,829,860,-31,31,137700,137500,6060,388740,382540,OK
229.221198,delay,Tick,829,860,-31,31,137700,137500,6060,388740,382540,OK
229.516219,delay,Tick,829,860,-31,31,137700,137600,6060,388740,385640,OK
229.730584,delay,Tick,829,870,-41,41,138100,137700,5922,389878,381678,OK
230.049869,delay,Tick,829,870,-41,41,138100,137700,5922,389878,381678,OK
230.299259,delay,Tick,829,870,-41,41,138100,137700,5922,389878,381678,OK
230.485699,delay,Tick,829,870,-41,41,138100,137700,5922,389878,381678,OK
230.756798,delay,Tick,829,870,-41,41,138100,137700,5922,389878,381678,OK
230.974543,delay,Tick,839,870,-31,31,137300,137600,5785,392015,398215,OK
231.263975,delay,Tick,839,870,-31,31,137300,137600,5785,392015,398215,OK
231.48721,delay,Tick,839,870,-31,31,137300,137600,5785,392015,398215,OK
231.719311,delay,Tick,839,870,-31,31,137300,137600,5785,392015,398215,OK
231.958498,delay,Tick,839,870,-31,31,137300,137600,5785,392015,398215,OK
232.263464,delay,Tick,839,870,-31,31,137300,137600,5785,392015,398215,OK
232.482283,delay,Tick,839,870,-31,31,137300,137600,5785,392015,398215,OK
232.769036,delay,Tick,849,870,-21,21,137400,137800,5648,395152,399352,OK
232.992448,delay,Tick,859,870,-11,11,137400,137800,5923,398877,401077,OK
233.269111,delay,Tick,869,870,-1,1,137400,137800,6198,402602,402802,OK
233.468555,delay,Tick,879,870,9,-9,137400,137800,6473,406327,404527,OK
233.744397,delay,Tick,889,870,19,-19,137400,137800,6748,411052,407252,OK
233.977186,delay,Tick,899,870,29,-29,137400,138100,7023,414777,408977,OK
234.242054,delay,Tick,909,870,39,-39,137700,138100,7298,418502,410702,OK
234.537481,delay,Tick,909,870,39,-39,137700,138100,7298,418502,410702,OK
234.709141,delay,Tick,909,870,39,-39,137700,138100,7298,418502,410702,OK
235.022564,delay,Tick,909,870,39,-39,137700,138100,7298,418502,410702,OK
235.238288,delay,Tick,909,870,39,-39,137700,138100,7298,418502,410702,OK
235.480215,delay,Tick,909,870,39,-39,137700,138100,7298,418502,410702,OK
235.701302,delay,Tick,909,870,39,-39,137700,138100,7298,418502,410702,OK
236.049097,delay,Tick,909,870,39,-39,137700,138100,7298,418502,410702,OK
236.260766,delay,Tick,909,870,39,-39,137700,138100,7298,418502,410702,OK
236.472913,delay,Tick,909,870,39,-39,137700,138100,7298,418502,410702,OK
236.747893,delay,Tick,909,870,39,-39,137700,138000,7298,418502,410702,OK
236.989212,delay,Tick,909,870,39,-39,138000,138000,7298,418502,418502,OK
237.218951,delay,Tick,909,870,39,-39,138000,138000,7298,418502,418502,OK
237.475521,delay,Tick,919,870,49,-49,137400,138000,7160,420640,410840,OK
237.780504,delay,Tick,919,870,49,-49,137400,138100,7160,420640,410840,OK
238.042541,delay,Tick,927,870,57,-57,137800,138100,7050,422350,410950,OK
238.27564,delay,Tick,927,870,57,-57,137800,138100,7050,422350,410950,OK
238.474771,delay,Tick,927,870,57,-57,137800,138100,7050,422350,410950,OK
238.737925,delay,Tick,927,870,57,-57,137800,138000,7050,422350,410950,OK
239.029787,delay,Tick,927,870,57,-57,138500,138000,7050,422350,433750,OK
239.221146,delay,Tick,927,870,57,-57,138500,138300,7050,422350,433750,OK
239.478349,delay,Tick,937,870,67,-67,137800,138300,6912,424488,411088,OK
239.739132,delay,Tick,937,870,67,-67,137800,138300,6912,424488,411088,OK
239.968898,delay,Tick,937,870,67,-67,137800,138300,6912,424488,411088,OK
240.245669,delay,Tick,937,870,67,-67,137800,138300,6912,424488,411088,OK
240.481385,delay,Tick,937,870,67,-67,137800,138100,6912,424488,411088,OK
240.738311,delay,Tick,937,870,67,-67,137800,138000,6912,424488,411088,OK
241.020041,delay,Tick,937,870,67,-67,137800,138200,6912,424488,411088,OK
241.258913,delay,Tick,947,870,77,-77,137900,138200,7188,427212,411812,OK
241.517143,delay,Tick,956,870,86,-86,137900,138200,7436,429664,412464,OK
241.794608,delay,Tick,956,870,86,-86,138500,138200,7436,429664,446864,OK
242.012498,delay,Tick,956,870,86,-86,138500,138200,7436,429664,446864,OK
242.206335,delay,Tick,956,870,86,-86,138500,138200,7436,429664,446864,OK
242.458477,delay,Tick,956,870,86,-86,138500,138200,7436,429664,446864,OK
242.800973,delay,Tick,960,870,90,-90,138000,138500,7381,430919,412919,OK
242.989765,delay,Tick,960,870,90,-90,138000,138500,7381,430919,412919,OK
243.268456,delay,Tick,960,870,90,-90,138000,138500,7381,430919,412919,OK
243.530074,delay,Tick,960,870,90,-90,138000,138500,7381,430919,412919,OK
243.70476,delay,Tick,960,870,90,-90,138000,138500,7381,430919,412919,OK
243.974697,delay,Tick,960,870,90,-90,138000,138800,7381,430919,412919,OK
244.230017,delay,Tick,960,870,90,-90,138200,138800,7381,430919,412919,OK
244.509967,delay,Tick,960,870,90,-90,138300,138800,7381,430919,412919,OK
244.793498,delay,Tick,960,870,90,-90,138300,138800,7381,430919,412919,OK
245.046485,delay,Tick,960,870,90,-90,138300,138800,7381,430919,412919,OK
245.241935,delay,Tick,960,870,90,-90,138300,138900,7381,430919,412919,OK
245.467589,delay,Tick,960,870,90,-90,138300,138900,7381,430919,412919,OK
245.791116,delay,Tick,960,870,90,-90,138800,138900,7381,430919,421919,OK
245.991169,delay,Tick,960,870,90,-90,138800,138900,7381,430919,421919,OK
246.235774,delay,Tick,960,870,90,-90,138800,138900,7381,430919,421919,OK
246.45438,delay,Tick,960,870,90,-90,138800,138900,7381,430919,421919,OK
246.792728,delay,Tick,960,870,90,-90,138600,138900,7381,430919,412919,OK
247.002443,delay,Tick,960,870,90,-90,138600,138900,7381,430919,412919,OK
247.300821,delay,Tick,960,870,90,-90,138600,138700,7381,430919,421919,OK
247.460487,delay,Tick,960,870,90,-90,138600,138700,7381,430919,421919,OK
247.708895,delay,Tick,960,870,90,-90,138600,138700,7381,430919,421919,OK
247.972493,delay,Tick,960,940,20,-20,137800,138700,9321,442979,438979,OK
248.248674,delay,Tick,960,940,20,-20,137800,138700,9321,442979,438979,OK
248.537348,delay,Tick,960,940,20,-20,137800,138700,9321,442979,438979,OK
248.742595,delay,Tick,970,940,30,-30,138200,138700,9183,445117,439117,OK
249.00836,delay,Tick,980,940,40,-40,138000,138400,9459,448841,440841,OK
249.292598,delay,Tick,990,940,50,-50,138000,138400,9735,451565,441565,OK
249.457421,delay,Tick,1000,940,60,-60,138000,138400,10011,454289,442289,OK
249.775208,delay,Tick,1010,940,70,-70,138000,138400,10287,457013,443013,OK
249.95565,delay,Tick,1020,940,80,-80,138000,138400,10563,459737,443737,OK
250.244037,delay,Tick,1030,940,90,-90,138000,138400,10839,462461,444461,OK
250.461926,delay,Tick,1030,940,90,-90,138000,138400,10839,462461,444461,OK
250.721571,delay,Tick,1030,940,90,-90,138000,138400,10839,462461,444461,OK
251.029387,delay,Tick,1030,940,90,-90,138000,138400,10839,462461,444461,OK
251.266443,delay,Tick,1030,940,90,-90,138300,138400,10839,462461,453461,OK
251.452188,delay,Tick,1030,1011,19,-19,138500,138400,12806,474694,476594,OK
251.717148,delay,Tick,1030,1011,19,-19,138500,138400,12806,474694,476594,OK
252.04754,delay,Tick,1040,1011,29,-29,138000,138300,12668,477832,472032,OK
252.256311,delay,Tick,1050,1011,39,-39,138000,138300,12944,480556,472756,OK
252.529285,delay,Tick,1059,1011,48,-48,138000,138300,13192,483008,473408,OK
252.790682,delay,Tick,1059,1011,48,-48,138000,138300,13192,483008,473408,OK
253.034377,delay,Tick,1059,1011,48,-48,138000,138500,13192,483008,473408,OK
253.219662,delay,Tick,1059,1011,48,-48,138000,138500,13192,483008,473408,OK
253.524142,delay,Tick,1059,1011,48,-48,138000,138500,13192,483008,473408,OK
253.749949,delay,Tick,1059,1011,48,-48,138000,138500,13192,483008,473408,OK
253.991728,delay,Tick,1059,1011,48,-48,138000,138500,13192,483008,473408,OK
254.297537,delay,Tick,1065,1011,54,-54,138300,138500,13109,483691,472891,OK
254.454051,delay,Tick,1065,1011,54,-54,138500,138500,13109,483691,483691,OK
254.755255,delay,Tick,1065,1011,54,-54,138500,138500,13109,483691,483691,OK
254.95837,delay,Tick,1065,1011,54,-54,138500,138500,13109,483691,483691,OK
255.246295,delay,Tick,1065,1011,54,-54,138500,138500,13109,483691,483691,OK
255.487621,delay,Tick,1065,1011,54,-54,138500,138500,13109,483691,483691,OK
255.752592,delay,Tick,1065,1011,54,-54,138500,138500,13109,483691,483691,OK
256.016292,delay,Tick,1065,1011,54,-54,138500,138500,13109,483691,483691,OK
256.289036,delay,Tick,1065,1011,54,-54,138500,138500,13109,483691,483691,OK
256.52888,delay,Tick,1065,1011,54,-54,138500,138400,13109,483691,489091,OK
256.755157,delay,Tick,1065,1011,54,-54,138500,138400,13109,483691,489091,OK
257.00136,delay,Tick,1065,1011,54,-54,138500,138400,13109,483691,489091,OK
257.29034,delay,Tick,1065,1011,54,-54,138500,138400,13109,483691,489091,OK
257.452666,delay,Tick,1065,1011,54,-54,138500,138400,13109,483691,489091,OK
257.765623,delay,Tick,1065,1011,54,-54,138500,138400,13109,483691,489091,OK
257.957034,delay,Tick,1065,1011,54,-54,138500,138400,13109,483691,489091,OK
258.249346,delay,Tick,1065,1011,54,-54,138500,138400,13109,483691,489091,OK
258.516361,delay,Tick,1075,1011,64,-64,137800,138400,12971,485829,473029,OK
258.701797,delay,Tick,1075,1011,64,-64,137800,138400,12971,485829,473029,OK
259.04416,delay,Tick,1075,1011,64,-64,137800,138400,12971,485829,473029,OK
259.280256,delay,Tick,1075,1011,64,-64,137800,138400,12971,485829,473029,OK
259.462671,delay,Tick,1075,1011,64,-64,137800,138400,12971,485829,473029,OK
259.717753,delay,Tick,1075,1011,64,-64,137800,138400,12971,485829,473029,OK
260.044739,delay,Tick,1075,1018,57,-57,138700,138400,12874,488726,500126,OK
260.249365,delay,Tick,1075,1018,57,-57,138700,138400,12874,488726,500126,OK
260.489479,delay,Tick,1075,1018,57,-57,138700,138400,12874,488726,500126,OK
260.754544,delay,Tick,1075,1018,57,-57,138700,138400,12874,488726,500126,OK
260.968537,delay,Tick,1075,1018,57,-57,138700,138200,12874,488726,500126,OK
261.261974,delay,Tick,1075,1018,57,-57,138700,138200,12874,488726,500126,OK
261.483894,delay,Tick,1075,1018,57,-57,138700,138200,12874,488726,500126,OK
261.733065,delay,Tick,1085,1018,67,-67,137700,138200,12736,490864,477464,OK
262.002798,delay,Tick,1085,1018,67,-67,137700,138200,12736,490864,477464,OK
262.222095,delay,Tick,1085,1018,67,-67,137700,138200,12736,490864,477464,OK
262.528892,delay,Tick,1095,1018,77,-77,137700,138200,12598,493002,477602,OK
262.773527,delay,Tick,1095,1018,77,-77,137700,138200,12598,493002,477602,OK
262.967553,delay,Tick,1095,1018,77,-77,138200,138200,12598,493002,493002,OK
263.218272,delay,Tick,1095,1018,77,-77,138200,138200,12598,493002,493002,OK
263.520385,delay,Tick,1095,1018,77,-77,138200,138200,12598,493002,493002,OK
263.748601,delay,Tick,1095,1018,77,-77,138200,138200,12598,493002,493002,OK
264.005576,delay,Tick,1095,1018,77,-77,138200,138200,12598,493002,493002,OK
264.300497,delay,Tick,1095,1018,77,-77,138200,138200,12598,493002,493002,OK
264.517111,delay,Tick,1095,1018,77,-77,138200,138200,12598,493002,493002,OK
264.74044,delay,Tick,1095,1018,77,-77,138200,138200,12598,493002,493002,OK
265.041971,delay,Tick,1095,1018,77,-77,138000,138200,12598,493002,477602,OK
265.214188,delay,Tick,1095,1018,77,-77,138000,138200,12598,493002,477602,OK
265.508974,delay,Tick,1095,1028,67,-67,138900,138200,12460,493140,506540,OK
265.71019,delay,Tick,1095,1028,67,-67,138900,138200,12460,493140,506540,OK
266.012956,delay,Tick,1095,1028,67,-67,138900,138200,12460,493140,506540,OK
266.217165,delay,Tick,1095,1038,57,-57,138900,138200,12321,495279,506679,OK
266.51706,delay,Tick,1095,1048,47,-47,139000,138200,12182,497418,506818,OK
266.729806,delay,Tick,1095,1048,47,-47,139000,138200,12182,497418,506818,OK
266.997382,delay,Tick,1095,1048,47,-47,139000,138200,12182,497418,506818,OK
267.204964,delay,Tick,1095,1048,47,-47,139000,138200,12182,497418,506818,OK
267.451359,delay,Tick,1095,1048,47,-47,139000,138500,12182,497418,506818,OK
267.789916,delay,Tick,1095,1048,47,-47,139000,138500,12182,497418,506818,OK
268.0552,delay,Tick,1095,1048,47,-47,139000,138500,12182,497418,506818,OK
268.219167,delay,Tick,1095,1048,47,-47,139000,138500,12182,497418,506818,OK
268.528912,delay,Tick,1095,1048,47,-47,138500,138500,12182,497418,497418,OK
268.778518,delay,Tick,1095,1048,47,-47,138500,138600,12182,497418,492718,OK
269.046389,delay,Tick,1095,1048,47,-47,138500,138600,12182,497418,492718,OK
269.301451,delay,Tick,1095,1048,47,-47,138500,138600,12182,497418,492718,OK
269.543277,delay,Tick,1095,1048,47,-47,138500,138600,12182,497418,492718,OK
269.732537,delay,Tick,1095,1048,47,-47,139000,138600,12182,497418,506818,OK
270.01915,delay,Tick,1095,1048,47,-47,139000,138600,12182,497418,506818,OK
270.207916,delay,Tick,1095,1048,47,-47,139000,138600,12182,497418,506818,OK
270.500693,delay,Tick,1095,1048,47,-47,139000,138600,12182,497418,506818,OK
270.71677,delay,Tick,1095,1048,47,-47,139000,138600,12182,497418,506818,OK
270.968577,delay,Tick,1095,1048,47,-47,139000,138600,12182,497418,506818,OK
271.288193,delay,Tick,1095,1058,37,-37,139200,138600,12043,499557,506957,OK
271.455589,delay,Tick,1095,1058,37,-37,139200,138600,12043,499557,506957,OK
271.792153,delay,Tick,1105,1058,47,-47,138200,138800,11904,501696,492296,OK
271.99438,delay,Tick,1115,1058,57,-57,138200,138800,11766,503834,492434,OK
272.285978,delay,Tick,1115,1058,57,-57,138200,138800,11766,503834,492434,OK
272.457548,delay,Tick,1115,1058,57,-57,138200,138700,11766,503834,492434,OK
272.76877,delay,Tick,1115,1058,57,-57,138200,138800,11766,503834,492434,OK
273.044771,delay,Tick,1115,1058,57,-57,138200,138800,11766,503834,492434,OK
273.245808,delay,Tick,1115,1058,57,-57,138200,138800,11766,503834,492434,OK
273.517987,delay,Tick,1115,1058,57,-57,138200,138800,11766,503834,492434,OK
273.765997,delay,Tick,1115,1058,57,-57,138200,138900,11766,503834,492434,OK
273.983777,delay,Tick,1115,1058,57,-57,138200,138900,11766,503834,492434,OK
274.23741,delay,Tick,1115,1058,57,-57,138200,138900,11766,503834,492434,OK
274.475555,delay,Tick,1115,1058,57,-57,138200,139100,11766,503834,492434,OK
274.779732,delay,Tick,1115,1058,57,-57,138200,139100,11766,503834,492434,OK
275.017918,delay,Tick,1115,1058,57,-57,138200,139100,11766,503834,492434,OK
275.289127,delay,Tick,1115,1058,57,-57,138200,139200,11766,503834,492434,OK
275.47693,delay,Tick,1115,1058,57,-57,138200,139200,11766,503834,492434,OK
275.782226,delay,Tick,1115,1058,57,-57,138200,139200,11766,503834,492434,OK
276.008815,delay,Tick,1115,1058,57,-57,138200,139300,11766,503834,492434,OK
276.287799,delay,Tick,1115,1058,57,-57,139100,139300,11766,503834,492434,OK
276.475563,delay,Tick,1125,1058,67,-67,139100,139400,12044,505556,492156,OK
276.747388,delay,Tick,1135,1058,77,-77,139100,139400,12322,507278,491878,OK
277.051746,delay,Tick,1135,1058,77,-77,139100,139400,12322,507278,491878,OK
277.236821,delay,Tick,1135,1058,77,-77,139100,139400,12322,507278,491878,OK
277.55046,delay,Tick,1135,1058,77,-77,139100,139400,12322,507278,491878,OK
277.741167,delay,Tick,1135,1058,77,-77,139100,139400,12322,507278,491878,OK
278.027677,delay,Tick,1135,1058,77,-77,139100,139400,12322,507278,491878,OK
278.253005,delay,Tick,1136,1058,78,-78,139100,139400,12308,507492,491892,OK
278.465072,delay,Tick,1136,1058,78,-78,139100,139400,12308,507492,491892,OK
278.795867,delay,Tick,1136,1058,78,-78,139100,139400,12308,507492,491892,OK
278.955455,delay,Tick,1136,1058,78,-78,139100,139400,12308,507492,491892,OK
279.23389,delay,Tick,1136,1058,78,-78,139100,139400,12308,507492,491892,OK
279.535721,delay,Tick,1136,1058,78,-78,139100,139400,12308,507492,491892,OK
279.752488,delay,Tick,1136,1058,78,-78,139100,139300,12308,507492,491892,OK
279.957395,delay,Tick,1136,1058,78,-78,139400,139400,12308,507492,507492,OK
280.280596,delay,Tick,1136,1058,78,-78,139400,139500,12308,507492,499692,OK
280.536727,delay,Tick,1136,1058,78,-78,139400,139500,12308,507492,499692,OK
280.741493,delay,Tick,1136,1058,78,-78,139400,139300,12308,507492,515292,OK
281.032186,delay,Tick,1136,1058,78,-78,139400,139300,12308,507492,515292,OK
281.272246,delay,Tick,1136,1058,78,-78,139400,139300,12308,507492,515292,OK
281.515791,delay,Tick,1136,1058,78,-78,139400,139300,12308,507492,515292,OK
281.716461,delay,Tick,1136,1058,78,-78,139400,139300,12308,507492,515292,OK
282.029141,delay,Tick,1146,1058,88,-78,138800,139300,12169,-882369,493031,OK
282.245886,delay,Tick,1146,1058,88,-88,138800,139300,12169,507631,490031,OK
282.541786,delay,Tick,1146,1058,88,-88,138800,139300,12169,507631,490031,OK
282.710647,delay,Tick,1148,1127,21,-21,139200,139300,11181,522819,520719,OK
283.022267,delay,Tick,1148,1127,21,-21,139200,139300,11181,522819,520719,OK
283.286455,delay,Tick,1148,1127,21,-21,139200,139300,11181,522819,520719,OK
283.476365,delay,Tick,1148,1127,21,-21,139200,139300,11181,522819,520719,OK
283.720378,delay,Tick,1148,1147,1,-1,139200,139300,10903,525097,524997,OK
283.974268,delay,Tick,1148,1147,1,-1,139200,139300,10903,525097,524997,OK
284.233778,delay,Tick,1148,1147,1,-1,139200,138700,10903,525097,525297,OK
284.546713,delay,Tick,1148,1147,1,-1,139200,138700,10903,525097,525297,OK
284.797921,delay,Tick,1148,1147,1,-1,138800,138700,10903,525097,525197,OK
284.995884,delay,Tick,1148,1147,1,-1,138800,138700,10903,525097,525197,OK
285.240235,delay,Tick,1148,1147,1,-1,138800,138700,10903,525097,525197,OK
285.527451,delay,Tick,1148,1147,1,-1,138800,138700,10903,525097,525197,OK
285.786698,delay,Tick,1148,1147,1,-1,138800,138700,10903,525097,525197,OK
286.045089,delay,Tick,1148,1147,1,-1,138800,138700,10903,525097,525197,OK
286.294307,delay,Tick,1148,1157,-9,9,139400,138700,10764,527236,525436,OK
286.527402,delay,Tick,1148,1167,-19,19,139500,138700,10625,529375,525575,OK
286.751146,delay,Tick,1148,1167,-19,19,138800,138700,10625,529375,527475,OK
286.980289,delay,Tick,1148,1167,-19,19,138800,138700,10625,529375,527475,OK
287.21666,delay,Tick,1148,1167,-19,19,138800,138700,10625,529375,527475,OK
287.538856,delay,Tick,1148,1167,-19,19,138800,138700,10625,529375,527475,OK
287.730986,delay,Tick,1148,1175,-27,19,139200,138700,10514,1643086,528086,OK
288.012395,delay,Tick,1148,1175,-27,27,139200,139000,10514,531086,525686,OK
288.296422,delay,Tick,1148,1185,-37,37,139500,139000,10375,533225,525825,OK
288.534466,delay,Tick,1148,1195,-47,47,139500,139000,10654,536946,527546,OK
288.729512,delay,Tick,1148,1198,-50,50,139500,139000,10738,538062,528062,OK
288.96232,delay,Tick,1148,1198,-50,50,139500,139000,10738,538062,528062,OK
289.23385,delay,Tick,1148,1198,-50,50,139500,139000,10738,538062,528062,OK
289.469185,delay,Tick,1148,1198,-50,50,139500,139000,10738,538062,528062,OK
289.732517,delay,Tick,1148,1198,-50,50,139500,139000,10738,538062,528062,OK
290.017046,delay,Tick,1148,1198,-50,50,139500,139000,10738,538062,528062,OK
290.286621,delay,Tick,1148,1198,-50,50,138900,139000,10738,538062,543062,OK
290.503635,delay,Tick,1148,1198,-50,50,138900,139000,10738,538062,543062,OK
290.763455,delay,Tick,1148,1198,-50,50,138900,139000,10738,538062,543062,OK
290.98139,delay,Tick,1148,1198,-50,50,138900,139000,10738,538062,543062,OK
291.248794,delay,Tick,1154,1198,-44,44,138700,139200,10655,539345,548145,OK
291.546115,delay,Tick,1154,1198,-44,44,138700,139200,10655,539345,548145,OK
291.706671,delay,Tick,1154,1198,-44,44,138700,139200,10655,539345,548145,OK
292.000095,delay,Tick,1154,1198,-44,44,138700,139200,10655,539345,548145,OK
292.31027,delay,Tick,1154,1198,-44,44,138700,139700,10655,539345,548145,OK
292.512175,delay,Tick,1154,1198,-44,44,138700,139800,10655,539345,548145,OK
292.775129,delay,Tick,1154,1198,-44,44,138700,139800,10655,539345,548145,OK
292.982009,delay,Tick,1154,1198,-44,44,138700,139800,10655,539345,548145,OK
293.225011,delay,Tick,1154,1198,-44,44,138700,139800,10655,539345,548145,OK
293.453564,delay,Tick,1164,1198,-34,34,139600,140000,10934,541066,547866,OK
293.791512,delay,Tick,1174,1198,-24,24,139600,140000,11213,543787,548587,OK
293.958998,delay,Tick,1184,1198,-14,14,139600,140000,11492,545508,548308,OK
294.242127,delay,Tick,1194,1198,-4,4,139600,139900,11771,547229,548029,OK
294.470573,delay,Tick,1204,1198,6,-6,139600,139900,12050,548950,547750,OK
294.787618,delay,Tick,1214,1198,16,-16,139600,139800,12329,550671,547471,OK
295.019935,delay,Tick,1224,1198,26,-26,139200,139800,12189,552811,547611,OK
295.298153,delay,Tick,1224,1198,26,-26,139200,139800,12189,552811,547611,OK
295.522537,delay,Tick,1224,1198,26,-26,139200,139800,12189,552811,547611,OK
295.772346,delay,Tick,1224,1198,26,-26,139200,139800,12189,552811,547611,OK
295.993659,delay,Tick,1224,1198,26,-26,139200,139800,12189,552811,547611,OK
296.290482,delay,Tick,1224,1198,26,-26,139200,139800,12189,552811,547611,OK
296.473438,delay,Tick,1224,1198,26,-26,139600,139800,12189,552811,547611,OK
296.779939,delay,Tick,1224,1198,26,-26,139600,139800,12189,552811,547611,OK
296.959864,delay,Tick,1224,1198,26,-26,139600,139800,12189,552811,547611,OK
297.267596,delay,Tick,1224,1198,26,-26,139600,139800,12189,552811,547611,OK
297.476533,delay,Tick,1224,1198,26,-26,139600,139800,12189,552811,547611,OK
297.709294,delay,Tick,1224,1198,26,-26,139600,139800,12189,552811,547611,OK
298.037212,delay,Tick,1224,1198,26,-26,139600,139800,12189,552811,547611,OK
298.295864,delay,Tick,1224,1198,26,-26,139600,139800,12189,552811,547611,OK
298.543888,delay,Tick,1224,1198,26,-26,139600,139800,12189,552811,547611,OK
298.748405,delay,Tick,1224,1198,26,-26,139600,139800,12189,552811,547611,OK
299.01957,delay,Tick,1224,1198,26,-26,139600,139800,12189,552811,547611,OK
299.243864,delay,Tick,1224,1198,26,-26,139600,139800,12189,552811,547611,OK
299.49696,delay,Tick,1224,1198,26,-26,139600,139800,12189,552811,547611,OK
299.7224,delay,Tick,1224,1198,26,-26,139600,139800,12189,552811,547611,OK
299.991287,delay,Tick,1234,1206,28,-28,138600,139200,11938,556662,551062,OK
300.239604,delay,Tick,1244,1206,38,-38,138800,139300,12216,559384,551784,OK
300.505526,delay,Tick,1254,1206,48,-48,138800,139500,12494,563106,553506,OK
300.745996,delay,Tick,1260,1206,54,-54,139300,139500,12410,563790,552990,OK
300.99149,delay,Tick,1270,1206,64,-64,139200,139500,12271,565929,553129,OK
301.276684,delay,Tick,1280,1206,74,-74,139200,139300,12549,566651,559251,OK
301.494605,delay,Tick,1280,1206,74,-74,139200,139200,12549,566651,566651,OK
301.739519,delay,Tick,1280,1206,74,-74,139200,139200,12549,566651,566651,OK
302.033131,delay,Tick,1280,1206,74,-74,139200,139100,12549,566651,574051,OK
302.212787,delay,Tick,1280,1206,74,-74,139200,139100,12549,566651,574051,OK
302.526623,delay,Tick,1280,1206,74,-74,139200,139100,12549,566651,574051,OK
302.711986,delay,Tick,1280,1206,74,-74,139200,139100,12549,566651,574051,OK
303.001288,delay,Tick,1280,1206,74,-74,139200,139100,12549,566651,574051,OK
303.231355,delay,Tick,1280,1206,74,-74,139200,139100,12549,566651,574051,OK
303.527828,delay,Tick,1290,1206,84,-84,138500,139100,12410,568790,551990,OK
303.750702,delay,Tick,1290,1206,84,-84,139200,138800,12410,568790,585590,OK
303.987463,delay,Tick,1290,1206,84,-84,138500,138800,12410,568790,551990,OK
304.282219,delay,Tick,1290,1206,84,-84,138500,138700,12410,568790,551990,OK
304.542076,delay,Tick,1290,1206,84,-84,138500,138700,12410,568790,551990,OK
304.712845,delay,Tick,1290,1206,84,-84,138500,138700,12410,568790,551990,OK
305.026635,delay,Tick,1290,1233,57,-57,139100,138900,12034,571866,583266,OK
305.253653,delay,Tick,1290,1233,57,-57,139100,138900,12034,571866,583266,OK
305.483079,delay,Tick,1290,1233,57,-57,139100,138900,12034,571866,583266,OK
305.763787,delay,Tick,1290,1233,57,-57,139100,138900,12034,571866,583266,OK
305.972436,delay,Tick,1290,1233,57,-57,139100,138900,12034,571866,583266,OK
306.219786,delay,Tick,1290,1233,57,-57,139100,138900,12034,571866,583266,OK
306.549731,delay,Tick,1290,1233,57,-57,139100,138900,12034,571866,583266,OK
306.725769,delay,Tick,1290,1233,57,-57,139100,138900,12034,571866,583266,OK
306.987022,delay,Tick,1290,1233,57,-57,139100,138900,12034,571866,583266,OK
307.266228,delay,Tick,1290,1233,57,-57,139200,138900,12034,571866,583266,OK
307.526477,delay,Tick,1290,1233,57,-57,139200,138900,12034,571866,583266,OK
307.735528,delay,Tick,1290,1233,57,-57,139200,138900,12034,571866,583266,OK
308.038949,delay,Tick,1290,1233,57,-57,139200,138900,12034,571866,583266,OK
308.285569,delay,Tick,1290,1233,57,-57,139200,138900,12034,571866,583266,OK
308.484829,delay,Tick,1290,1233,57,-57,139200,138900,12034,571866,583266,OK
308.762269,delay,Tick,1290,1233,57,-57,139200,138900,12034,571866,583266,OK
308.970328,delay,Tick,1290,1233,57,-57,139200,138900,12034,571866,583266,OK
309.292643,delay,Tick,1290,1233,57,-57,139200,138900,12034,571866,583266,OK
309.480948,delay,Tick,1290,1233,57,-57,139200,138900,12034,571866,583266,OK
309.753962,delay,Tick,1290,1233,57,-57,139200,138900,12034,571866,583266,OK
309.969262,delay,Tick,1290,1233,57,-57,139200,138900,12034,571866,583266,OK
310.223826,delay,Tick,1290,1238,52,-52,139100,138900,11964,572936,583336,OK
310.505377,delay,Tick,1290,1238,52,-52,139100,138600,11964,572936,583336,OK
310.788385,delay,Tick,1290,1238,52,-52,138800,138600,11964,572936,583336,OK
311.009207,delay,Tick,1290,1238,52,-52,138800,138600,11964,572936,583336,OK
311.246323,delay,Tick,1290,1238,52,-52,138800,138600,11964,572936,583336,OK
311.543384,delay,Tick,1290,1238,52,-52,138800,138600,11964,572936,583336,OK
311.752677,delay,Tick,1290,1238,52,-52,138800,138600,11964,572936,583336,OK
311.975907,delay,Tick,1290,1238,52,-52,138800,138700,11964,572936,578136,OK
312.247047,delay,Tick,1290,1238,52,-52,138800,138800,11964,572936,572936,OK
312.496917,delay,Tick,1290,1238,52,-52,138800,138800,11964,572936,572936,OK
312.798213,delay,Tick,1290,1238,52,-52,138800,138800,11964,572936,572936,OK
312.971145,delay,Tick,1290,1238,52,-52,138800,138800,11964,572936,572936,OK
313.202447,delay,Tick,1291,1238,53,-53,138700,138800,11950,573150,567850,OK
313.541891,delay,Tick,1291,1238,53,-53,138700,138800,11950,573150,567850,OK
313.762151,delay,Tick,1291,1238,53,-53,138700,138800,11950,573150,567850,OK
313.994837,delay,Tick,1291,1238,53,-53,138700,138800,11950,573150,567850,OK
314.246837,delay,Tick,1291,1238,53,-53,138700,138800,11950,573150,567850,OK
314.493997,delay,Tick,1291,1248,43,-43,139400,138700,11811,576289,584889,OK
314.735031,delay,Tick,1291,1248,43,-43,139400,138600,11811,576289,584889,OK
315.042255,delay,Tick,1291,1248,43,-43,139400,138600,11811,576289,584889,OK
315.231724,delay,Tick,1291,1248,43,-43,139400,138600,11811,576289,584889,OK
315.516915,delay,Tick,1291,1248,43,-43,139400,138600,11811,576289,584889,OK
315.785734,delay,Tick,1291,1248,43,-43,139400,138600,11811,576289,584889,OK
316.046622,delay,Tick,1291,1248,43,-43,138500,138600,11811,576289,571989,OK
316.240228,delay,Tick,1291,1248,43,-43,138500,138600,11811,576289,571989,OK
316.535701,delay,Tick,1291,1248,43,-43,138500,138600,11811,576289,571989,OK
316.775548,delay,Tick,1291,1258,33,-33,139000,138600,11672,578428,585028,OK
317.030673,delay,Tick,1291,1258,33,-33,139000,138600,11672,578428,585028,OK
317.212568,delay,Tick,1291,1258,33,-33,139000,138600,11672,578428,585028,OK
317.476937,delay,Tick,1291,1268,23,-23,138900,138600,11533,581567,586167,OK
317.751384,delay,Tick,1291,1268,23,-23,138900,138600,11533,581567,586167,OK
317.999859,delay,Tick,1291,1268,23,-23,138900,138600,11533,581567,586167,OK
318.241026,delay,Tick,1291,1268,23,-23,138900,138600,11533,581567,586167,OK
318.489942,delay,Tick,1291,1278,13,-13,138900,138600,11394,584706,587306,OK
318.739801,delay,Tick,1291,1288,3,-3,138500,138600,11671,586429,586129,OK
319.041648,delay,Tick,1291,1298,-7,7,138800,138600,11948,588552,587152,OK
319.284527,delay,Tick,1291,1308,-17,17,138400,138600,12225,590275,593675,OK
319.512549,delay,Tick,1291,1318,-27,27,138400,138600,12502,591998,597398,OK
319.785544,delay,Tick,1291,1328,-37,37,138400,138100,12779,593721,586321,OK
320.027667,delay,Tick,1291,1338,-47,47,138400,138100,13056,595444,586044,OK
320.292674,delay,Tick,1291,1348,-57,57,138400,138100,13333,598167,586767,OK
320.464176,delay,Tick,1291,1358,-67,67,138400,138000,13610,600890,587490,OK
320.726308,delay,Tick,1291,1368,-77,77,138400,138000,13887,603613,588213,OK
321.001885,delay,Tick,1291,1378,-87,87,138400,138000,14163,606837,589437,OK
321.226241,delay,Tick,1291,1381,-90,90,138400,138000,14246,607654,589654,OK
321.468196,delay,Tick,1291,1381,-90,90,138400,138000,14246,607654,589654,OK
321.753102,delay,Tick,1291,1381,-90,90,138400,138000,14246,607654,589654,OK
321.986992,delay,Tick,1291,1381,-90,90,138400,138000,14246,607654,589654,OK
322.215687,delay,Tick,1291,1381,-90,90,138400,138000,14246,607654,589654,OK
322.47125,delay,Tick,1291,1381,-90,90,138300,138000,14246,607654,589654,OK
322.784788,delay,Tick,1291,1381,-90,90,138300,138000,14246,607654,589654,OK
322.973339,delay,Tick,1291,1381,-90,90,138600,138000,14246,607654,589654,OK
323.266542,delay,Tick,1291,1381,-90,90,138200,138100,14246,607654,598654,OK
323.464154,delay,Tick,1291,1381,-90,90,138200,138100,14246,607654,598654,OK
323.75413,delay,Tick,1291,1381,-90,90,138100,138200,14246,607654,616654,OK
324.041038,delay,Tick,1291,1381,-90,90,138100,138200,14246,607654,616654,OK
324.23742,delay,Tick,1291,1381,-90,90,138100,138200,14246,607654,616654,OK
324.47755,delay,Tick,1291,1381,-90,90,138100,138200,14246,607654,616654,OK
324.7625,delay,Tick,1291,1381,-90,90,138100,138200,14246,607654,616654,OK
325.027914,delay,Tick,1291,1381,-90,90,138100,138200,14246,607654,616654,OK
325.242344,delay,Tick,1291,1381,-90,90,138100,138200,14246,607654,616654,OK
325.531423,delay,Tick,1291,1381,-90,90,138100,138300,14246,607654,625654,OK
325.710592,delay,Tick,1291,1381,-90,90,138100,138300,14246,607654,625654,OK
326.020138,delay,Tick,1291,1381,-90,90,138100,138300,14246,607654,625654,OK
326.308139,delay,Tick,1291,1381,-90,90,138600,138300,14246,607654,589654,OK
326.549765,delay,Tick,1291,1381,-90,90,138600,138300,14246,607654,589654,OK
326.788321,delay,Tick,1291,1381,-90,90,138600,138300,14246,607654,589654,OK
327.003134,delay,Tick,1291,1381,-90,90,138600,138300,14246,607654,589654,OK
327.270774,delay,Tick,1291,1381,-90,90,138600,138400,14246,607654,589654,OK
327.523225,delay,Tick,1291,1381,-90,90,138600,138400,14246,607654,589654,OK
327.789722,delay,Tick,1291,1381,-90,90,138600,138400,14246,607654,589654,OK
328.00306,delay,Tick,1291,1381,-90,90,138600,138400,14246,607654,589654,OK
328.238348,delay,Tick,1291,1381,-90,90,138600,138400,14246,607654,589654,OK
328.536241,delay,Tick,1291,1381,-90,90,138600,138400,14246,607654,589654,OK
328.723837,delay,Tick,1291,1381,-90,90,138300,138400,14246,607654,616654,OK
328.997507,delay,Tick,1328,1381,-53,53,138300,138400,13734,611866,617166,OK
329.298183,delay,Tick,1328,1381,-53,53,138300,138500,13734,611866,622466,OK
329.509233,delay,Tick,1328,1381,-53,53,138300,138600,13734,611866,622466,OK
329.732809,delay,Tick,1328,1381,-53,53,138300,138600,13734,611866,622466,OK
329.977383,delay,Tick,1328,1381,-53,53,138300,138600,13734,611866,622466,OK
330.225592,delay,Tick,1328,1381,-53,53,138300,138600,13734,611866,622466,OK
330.461687,delay,Tick,1328,1391,-63,63,139000,138600,13595,614005,601405,OK
330.76414,delay,Tick,1338,1391,-53,53,138200,138600,13457,616143,626743,OK
330.957287,delay,Tick,1348,1391,-43,43,138200,138600,13733,617867,626467,OK
331.242176,delay,Tick,1357,1391,-34,34,138200,138600,13982,620318,627118,OK
331.547656,delay,Tick,1357,1391,-34,34,138200,138600,13982,620318,627118,OK
331.732741,delay,Tick,1357,1391,-34,34,138200,138600,13982,620318,627118,OK
331.968579,delay,Tick,1357,1391,-34,34,138200,138600,13982,620318,627118,OK
332.247176,delay,Tick,1357,1391,-34,34,138200,138600,13982,620318,627118,OK
332.528098,delay,Tick,1357,1391,-34,34,138200,138600,13982,620318,627118,OK
332.732614,delay,Tick,1357,1391,-34,34,138200,138600,13982,620318,627118,OK
332.957215,delay,Tick,1357,1391,-34,34,138100,138600,13982,620318,627118,OK
333.279801,delay,Tick,1357,1401,-44,44,138700,138600,13843,622457,618057,OK
333.528921,delay,Tick,1357,1411,-54,54,138800,138600,14121,626179,615379,OK
333.729566,delay,Tick,1357,1421,-64,64,138800,138600,14399,628901,616101,OK
334.047766,delay,Tick,1357,1431,-74,74,138800,138500,14677,631623,616823,OK
334.227481,delay,Tick,1357,1441,-84,84,139000,138500,14955,633345,616545,OK
334.508657,delay,Tick,1357,1447,-90,90,138800,138500,15122,634378,616378,OK
334.731586,delay,Tick,1357,1447,-90,90,138800,138500,15122,634378,616378,OK
335.025631,delay,Tick,1357,1447,-90,90,138700,138500,15122,634378,616378,OK
335.276049,delay,Tick,1357,1447,-90,90,138100,138500,15122,634378,652378,OK
335.461783,delay,Tick,1357,1447,-90,90,138100,138500,15122,634378,652378,OK
335.741386,delay,Tick,1357,1447,-90,90,138100,138500,15122,634378,652378,OK
335.961644,delay,Tick,1357,1447,-90,90,138100,138500,15122,634378,652378,OK
336.201544,delay,Tick,1357,1447,-90,90,138100,138500,15122,634378,652378,OK
336.516024,delay,Tick,1357,1447,-90,90,138100,138600,15122,634378,652378,OK
336.752977,delay,Tick,1357,1447,-90,90,138100,138600,15122,634378,652378,OK
336.960958,delay,Tick,1357,1447,-90,90,138100,138600,15122,634378,652378,OK
337.292895,delay,Tick,1380,1447,-67,67,138400,138600,14804,639296,652696,OK
337.489645,delay,Tick,1380,1447,-67,67,138400,138600,14804,639296,652696,OK
337.702396,delay,Tick,1380,1447,-67,67,138400,138600,14804,639296,652696,OK
338.009056,delay,Tick,1390,1447,-57,57,138100,138600,14666,641434,652834,OK
338.204719,delay,Tick,1390,1447,-57,57,138100,138600,14666,641434,652834,OK
338.541772,delay,Tick,1390,1457,-67,67,139200,138600,14527,644573,631173,OK
338.720887,delay,Tick,1390,1457,-67,67,139200,138600,14527,644573,631173,OK
339.035039,delay,Tick,1390,1457,-67,67,139200,138600,14527,644573,631173,OK
339.248039,delay,Tick,1390,1457,-67,67,139200,138600,14527,644573,631173,OK
339.481186,delay,Tick,1390,1457,-67,67,139200,138500,14527,644573,631173,OK
339.7242,delay,Tick,1390,1457,-67,67,139200,138600,14527,644573,631173,OK
340.048659,delay,Tick,1390,1457,-67,67,139200,138600,14527,644573,631173,OK
340.303265,delay,Tick,1390,1457,-67,67,139200,138600,14527,644573,631173,OK
340.546731,delay,Tick,1390,1457,-67,67,139200,138600,14527,644573,631173,OK
340.786588,delay,Tick,1390,1457,-67,67,139200,138600,14527,644573,631173,OK
341.032845,delay,Tick,1390,1457,-67,67,139200,138600,14527,644573,631173,OK
341.284319,delay,Tick,1400,1457,-57,57,138100,138600,14389,647711,659111,OK
341.531101,delay,Tick,1400,1467,-67,67,139300,138800,14250,649850,636450,OK
341.775853,delay,Tick,1400,1467,-67,67,139300,138800,14250,649850,636450,OK
341.961862,delay,Tick,1400,1467,-67,67,139300,138800,14250,649850,636450,OK
342.225235,delay,Tick,1400,1477,-77,77,139300,138800,14111,652989,637589,OK
342.551424,delay,Tick,1400,1477,-77,77,139300,138800,14111,652989,637589,OK
342.736552,delay,Tick,1400,1477,-77,77,139300,138800,14111,652989,637589,OK
342.995099,delay,Tick,1400,1477,-77,77,139300,138800,14111,652989,637589,OK
343.230932,delay,Tick,1400,1477,-77,77,139300,138800,14111,652989,637589,OK
343.530633,delay,Tick,1410,1477,-67,67,138300,139000,13972,656128,669528,OK
343.768701,delay,Tick,1420,1477,-57,57,138800,139000,14250,657850,669250,OK
344.049298,delay,Tick,1430,1477,-47,47,138500,139000,14528,659572,668972,OK
344.204335,delay,Tick,1431,1477,-46,46,138800,139000,14556,659744,668944,OK
344.455765,delay,Tick,1440,1477,-37,37,138500,139000,14431,662569,669969,OK
344.785112,delay,Tick,1440,1477,-37,37,138500,139000,14431,662569,669969,OK
345.032952,delay,Tick,1440,1477,-37,37,138500,139300,14431,662569,669969,OK
345.274711,delay,Tick,1440,1477,-37,37,138500,139300,14431,662569,669969,OK
345.542698,delay,Tick,1450,1477,-27,27,138700,139300,14292,665708,671108,OK
345.776823,delay,Tick,1450,1477,-27,27,138700,139300,14292,665708,671108,OK
345.992394,delay,Tick,1450,1477,-27,27,138700,139300,14292,665708,671108,OK
346.20531,delay,Tick,1450,1477,-27,27,138700,139300,14292,665708,671108,OK
346.488937,delay,Tick,1450,1477,-27,27,138700,139300,14292,665708,671108,OK
346.721134,delay,Tick,1450,1477,-27,27,138700,139300,14292,665708,671108,OK
347.03232,delay,Tick,1460,1477,-17,17,139200,139300,14570,667430,669130,OK
347.228411,delay,Tick,1470,1477,-7,7,139300,139800,14849,671151,672551,OK
347.471474,delay,Tick,1480,1477,3,-3,139300,139800,15128,673872,673272,OK
347.776073,delay,Tick,1490,1477,13,-13,139300,139800,15407,675593,672993,OK
347.994834,delay,Tick,1500,1477,23,-23,139300,139600,15686,678314,673714,OK
348.212659,delay,Tick,1510,1477,33,-33,139300,139500,15965,680035,673435,OK
348.537212,delay,Tick,1510,1477,33,-33,139300,139500,15965,680035,673435,OK
348.757568,delay,Tick,1520,1477,43,-43,139400,139500,16244,681756,677456,OK
349.004088,delay,Tick,1520,1477,43,-43,139400,139500,16244,681756,677456,OK
349.247295,delay,Tick,1520,1477,43,-43,139400,139500,16244,681756,677456,OK
349.484274,delay,Tick,1520,1477,43,-43,139400,139500,16244,681756,677456,OK
349.70217,delay,Tick,1520,1477,43,-43,139400,139500,16244,681756,677456,OK
349.99533,delay,Tick,1520,1477,43,-43,139400,139500,16244,681756,677456,OK
350.277819,delay,Tick,1523,1477,46,-46,139400,139500,16328,682272,677672,OK
350.468777,delay,Tick,1523,1477,46,-46,139400,139500,16328,682272,677672,OK
350.759965,delay,Tick,1523,1477,46,-46,139400,139500,16328,682272,677672,OK
351.010027,delay,Tick,1523,1477,46,-46,139400,139500,16328,682272,677672,OK
351.269228,delay,Tick,1523,1477,46,-46,139400,139500,16328,682272,677672,OK
351.485962,delay,Tick,1523,1477,46,-46,139500,139500,16328,682272,682272,OK
351.794464,delay,Tick,1523,1477,46,-46,139500,139500,16328,682272,682272,OK
352.030341,delay,Tick,1523,1477,46,-46,139500,139800,16328,682272,673072,OK
352.216257,delay,Tick,1533,1477,56,-56,139500,139800,16607,683993,672793,OK
352.503939,delay,Tick,1533,1477,56,-56,139500,139800,16607,683993,672793,OK
352.743437,delay,Tick,1533,1477,56,-56,139500,139800,16607,683993,672793,OK
352.971097,delay,Tick,1543,1477,66,-66,139500,139700,16886,685714,672514,OK
353.229836,delay,Tick,1543,1477,66,-66,139500,139500,16886,685714,685714,OK
353.452343,delay,Tick,1543,1477,66,-66,139500,139500,16886,685714,685714,OK
353.719471,delay,Tick,1543,1477,66,-66,139500,139500,16886,685714,685714,OK
354.048675,delay,Tick,1543,1477,66,-66,139600,139500,16886,685714,692314,OK
354.241115,delay,Tick,1543,1477,66,-66,139600,139500,16886,685714,692314,OK
354.474611,delay,Tick,1543,1477,66,-66,139600,139500,16886,685714,692314,OK
354.73644,delay,Tick,1543,1477,66,-66,139600,139500,16886,685714,692314,OK
355.0487,delay,Tick,1543,1477,66,-66,139600,139600,16886,685714,685714,OK
355.287892,delay,Tick,1543,1477,66,-66,139600,139600,16886,685714,685714,OK
355.483947,delay,Tick,1543,1477,66,-66,139600,139600,16886,685714,685714,OK
355.772099,delay,Tick,1543,1477,66,-66,139600,139600,16886,685714,685714,OK
356.048232,delay,Tick,1548,1477,71,-71,139600,139600,17026,686574,686574,OK
356.244743,delay,Tick,1548,1477,71,-71,139600,139600,17026,686574,686574,OK
356.499938,delay,Tick,1548,1477,71,-71,139600,139600,17026,686574,686574,OK
356.759774,delay,Tick,1548,1477,71,-71,139600,139600,17026,686574,686574,OK
357.013864,delay,Tick,1548,1477,71,-71,139600,139600,17026,686574,686574,OK
357.221884,delay,Tick,1558,1477,81,-81,139200,139600,16886,688714,672514,OK
357.470016,delay,Tick,1558,1477,81,-81,139200,139600,16886,688714,672514,OK
357.799578,delay,Tick,1558,1477,81,-81,139700,139600,16886,688714,696814,OK
357.988862,delay,Tick,1558,1477,81,-81,139700,139900,16886,688714,672514,OK
358.29172,delay,Tick,1558,1477,81,-81,139700,139900,16886,688714,672514,OK
358.456622,delay,Tick,1558,1477,81,-81,139700,139900,16886,688714,672514,OK
358.797882,delay,Tick,1567,1477,90,-90,139200,139800,16760,689740,671740,OK
359.006787,delay,Tick,1567,1477,90,-90,139200,139800,16760,689740,671740,OK
359.272232,delay,Tick,1567,1477,90,-90,139200,139800,16760,689740,671740,OK
359.458955,delay,Tick,1567,1477,90,-90,139100,139800,16760,689740,671740,OK
359.758738,delay,Tick,1567,1477,90,-90,139100,139800,16760,689740,671740,OK
359.993293,delay,Tick,1567,1477,90,-90,139100,139800,16760,689740,671740,OK
360.236597,delay,Tick,1567,1477,90,-90,139100,139800,16760,689740,671740,OK
360.469542,delay,Tick,1567,1477,90,-90,139100,139800,16760,689740,671740,OK
360.778306,delay,Tick,1567,1477,90,-90,139100,139800,16760,689740,671740,OK
361.034165,delay,Tick,1567,1477,90,-90,139900,139800,16760,689740,698740,OK
361.235793,delay,Tick,1567,1477,90,-90,139900,139800,16760,689740,698740,OK
361.542108,delay,Tick,1567,1477,90,-90,139900,139800,16760,689740,698740,OK
361.794426,delay,Tick,1567,1477,90,-90,139900,139800,16760,689740,698740,OK
362.036244,delay,Tick,1567,1477,90,-90,139900,139800,16760,689740,698740,OK
362.24821,delay,Tick,1567,1477,90,-90,139900,139800,16760,689740,698740,OK
362.545783,delay,Tick,1567,1477,90,-90,139900,139800,16760,689740,698740,OK
362.794615,delay,Tick,1567,1477,90,-90,139400,139800,16760,689740,671740,OK
362.963915,delay,Tick,1567,1477,90,-90,139400,139800,16760,689740,671740,OK
363.214641,delay,Tick,1567,1477,90,-90,139400,140300,16760,689740,671740,OK
363.451775,delay,Tick,1567,1477,90,-90,139900,140200,16760,689740,671740,OK
363.704149,delay,Tick,1567,1477,90,-90,139900,140100,16760,689740,671740,OK
364.045374,delay,Tick,1567,1477,90,-90,139900,140000,16760,689740,680740,OK
364.226397,delay,Tick,1567,1477,90,-90,139900,140000,16760,689740,680740,OK
364.528798,delay,Tick,1567,1477,90,-90,139900,140200,16760,689740,671740,OK
364.760456,delay,Tick,1567,1477,90,-90,139900,140200,16760,689740,671740,OK
364.973327,delay,Tick,1567,1477,90,-90,139600,140200,16760,689740,671740,OK
365.216291,delay,Tick,1567,1477,90,-90,139600,140200,16760,689740,671740,OK
365.478074,delay,Tick,1567,1477,90,-90,139600,140000,16760,689740,671740,OK
365.744245,delay,Tick,1567,1477,90,-90,139600,140000,16760,689740,671740,OK
365.97165,delay,Tick,1567,1477,90,-90,139600,140000,16760,689740,671740,OK
366.243083,delay,Tick,1567,1477,90,-90,139600,140000,16760,689740,671740,OK
366.548103,delay,Tick,1567,1477,90,-90,139600,140000,16760,689740,671740,OK
366.786459,delay,Tick,1567,1477,90,-90,139600,140000,16760,689740,671740,OK
367.037631,delay,Tick,1567,1477,90,-90,139600,140100,16760,689740,671740,OK
367.20821,delay,Tick,1567,1477,90,-90,140000,140100,16760,689740,680740,OK
367.496392,delay,Tick,1567,1477,90,-90,140000,140100,16760,689740,680740,OK
367.799081,delay,Tick,1567,1477,90,-90,140000,140100,16760,689740,680740,OK
367.953449,delay,Tick,1567,1477,90,-90,140000,140100,16760,689740,680740,OK
368.264679,delay,Tick,1567,1477,90,-90,140000,140400,16760,689740,671740,OK
368.463615,delay,Tick,1567,1477,90,-90,140000,140400,16760,689740,671740,OK
368.789533,delay,Tick,1567,1477,90,-90,140000,140500,16760,689740,671740,OK
368.997489,delay,Tick,1567,1477,90,-90,140000,140500,16760,689740,671740,OK
369.204116,delay,Tick,1567,1477,90,-90,140000,140600,16760,689740,671740,OK
369.485271,delay,Tick,1567,1477,90,-90,140000,140600,16760,689740,671740,OK
369.701933,delay,Tick,1567,1477,90,-90,140000,140600,16760,689740,671740,OK
369.973461,delay,Tick,1567,1477,90,-90,140000,140600,16760,689740,671740,OK
370.24732,delay,Tick,1567,1477,90,-90,140000,140600,16760,689740,671740,OK
370.496275,delay,Tick,1567,1477,90,-90,140000,140600,16760,689740,671740,OK
370.747038,delay,Tick,1567,1477,90,-90,140400,141000,16760,689740,671740,OK
370.965334,delay,Tick,1567,1477,90,-90,140400,141000,16760,689740,671740,OK
371.221956,delay,Tick,1567,1477,90,-90,140400,141000,16760,689740,671740,OK
371.513576,delay,Tick,1567,1477,90,-90,140400,141000,16760,689740,671740,OK
371.749595,delay,Tick,1567,1477,90,-90,140400,141000,16760,689740,671740,OK
371.972255,delay,Tick,1567,1477,90,-90,140400,141000,16760,689740,671740,OK
372.265193,delay,Tick,1567,1477,90,-90,140400,141000,16760,689740,671740,OK
372.477481,delay,Tick,1567,1477,90,-90,140400,140900,16760,689740,671740,OK
372.706354,delay,Tick,1567,1477,90,-90,140600,140900,16760,689740,671740,OK
372.997856,delay,Tick,1567,1477,90,-90,140600,140900,16760,689740,671740,OK
373.24729,delay,Tick,1567,1477,90,-90,140600,140900,16760,689740,671740,OK
373.538163,delay,Tick,1567,1477,90,-90,140600,140900,16760,689740,671740,OK
373.726614,delay,Tick,1567,1477,90,-90,140600,140900,16760,689740,671740,OK
373.960675,delay,Tick,1567,1477,90,-90,140600,140900,16760,689740,671740,OK
374.220887,delay,Tick,1567,1477,90,-90,140600,140900,16760,689740,671740,OK
374.522481,delay,Tick,1567,1477,90,-90,140600,140900,16760,689740,671740,OK
374.752958,delay,Tick,1567,1477,90,-90,140600,140900,16760,689740,671740,OK
375.025004,delay,Tick,1567,1477,90,-90,140600,140900,16760,689740,671740,OK
375.208129,delay,Tick,1567,1477,90,-90,140600,140800,16760,689740,671740,OK
375.518999,delay,Tick,1567,1477,90,-90,140600,140700,16760,689740,680740,OK
375.727192,delay,Tick,1567,1477,90,-90,140600,140700,16760,689740,680740,OK
376.039093,delay,Tick,1567,1477,90,-90,140600,140700,16760,689740,680740,OK
376.260992,delay,Tick,1567,1477,90,-90,140600,140700,16760,689740,680740,OK
376.515878,delay,Tick,1567,1477,90,-90,140600,140700,16760,689740,680740,OK
376.78541,delay,Tick,1567,1477,90,-90,140600,140700,16760,689740,680740,OK
377.035219,delay,Tick,1567,1477,90,-90,140600,140700,16760,689740,680740,OK
377.245265,delay,Tick,1567,1477,90,-90,140600,140700,16760,689740,680740,OK
377.452925,delay,Tick,1567,1477,90,-90,140600,140700,16760,689740,680740,OK
377.732915,delay,Tick,1567,1477,90,-90,140600,140700,16760,689740,680740,OK
377.995479,delay,Tick,1567,1477,90,-90,140600,140700,16760,689740,680740,OK
378.264111,delay,Tick,1567,1477,90,-90,140600,140700,16760,689740,680740,OK
378.451568,delay,Tick,1567,1477,90,-90,140600,140700,16760,689740,680740,OK
378.752007,delay,Tick,1567,1477,90,-90,140600,140700,16760,689740,680740,OK
379.014683,delay,Tick,1567,1477,90,-90,140600,140700,16760,689740,680740,OK
379.298255,delay,Tick,1567,1477,90,-90,140600,140700,16760,689740,680740,OK
379.509265,delay,Tick,1567,1477,90,-90,140600,140700,16760,689740,680740,OK
379.751326,delay,Tick,1567,1477,90,-90,140600,140700,16760,689740,680740,OK
379.966565,delay,Tick,1567,1477,90,-90,140600,140700,16760,689740,680740,OK
380.281386,delay,Tick,1567,1477,90,-90,140600,140700,16760,689740,680740,OK
380.460319,delay,Tick,1567,1477,90,-90,140600,140700,16760,689740,680740,OK
380.73497,delay,Tick,1567,1477,90,-90,140600,140700,16760,689740,680740,OK
380.978182,delay,Tick,1567,1477,90,-90,140600,140700,16760,689740,680740,OK
381.240957,delay,Tick,1567,1477,90,-90,140600,140700,16760,689740,680740,OK
381.467574,delay,Tick,1567,1477,90,-90,140600,140700,16760,689740,680740,OK
381.752725,delay,Tick,1567,1477,90,-90,140700,140700,16760,689740,689740,OK
381.964329,delay,Tick,1567,1477,90,-90,140700,140700,16760,689740,689740,OK
382.282923,delay,Tick,1567,1477,90,-90,140700,140700,16760,689740,689740,OK
382.503708,delay,Tick,1567,1477,90,-90,140700,140700,16760,689740,689740,OK
382.728925,delay,Tick,1567,1477,90,-90,140700,140900,16760,689740,671740,OK
383.012815,delay,Tick,1567,1477,90,-90,140700,140900,16760,689740,671740,OK
383.296526,delay,Tick,1567,1477,90,-90,140700,140900,16760,689740,671740,OK
383.490398,delay,Tick,1567,1477,90,-90,140700,140900,16760,689740,671740,OK
383.716876,delay,Tick,1567,1477,90,-90,140700,140900,16760,689740,671740,OK
383.987968,delay,Tick,1567,1477,90,-90,140700,140900,16760,689740,671740,OK
384.284574,delay,Tick,1567,1477,90,-90,140700,140900,16760,689740,671740,OK
384.522005,delay,Tick,1567,1477,90,-90,140700,140900,16760,689740,671740,OK
384.700777,delay,Tick,1567,1477,90,-90,140700,140900,16760,689740,671740,OK
384.988625,delay,Tick,1567,1477,90,-90,140700,140900,16760,689740,671740,OK
385.265295,delay,Tick,1567,1477,90,-90,140700,140900,16760,689740,671740,OK
385.504299,delay,Tick,1567,1477,90,-90,140700,140700,16760,689740,689740,OK
385.731899,delay,Tick,1567,1477,90,-90,140700,140900,16760,689740,671740,OK
385.960076,delay,Tick,1567,1477,90,-90,140700,140900,16760,689740,671740,OK
386.222722,delay,Tick,1567,1477,90,-90,140700,140900,16760,689740,671740,OK
386.528224,delay,Tick,1567,1477,90,-90,140700,140900,16760,689740,671740,OK
386.769369,delay,Tick,1567,1477,90,-90,140700,140900,16760,689740,671740,OK
386.997563,delay,Tick,1567,1477,90,-90,140700,141100,16760,689740,671740,OK
387.287187,delay,Tick,1567,1477,90,-90,140700,141400,16760,689740,671740,OK
387.461559,delay,Tick,1567,1477,90,-90,140600,141400,16760,689740,671740,OK
387.725243,delay,Tick,1567,1477,90,-90,140800,141400,16760,689740,671740,OK
387.977046,delay,Tick,1567,1477,90,-90,140800,141400,16760,689740,671740,OK
388.259567,delay,Tick,1567,1477,90,-90,140800,141400,16760,689740,671740,OK
388.483886,delay,Tick,1567,1477,90,-90,140800,141400,16760,689740,671740,OK
388.723651,delay,Tick,1567,1477,90,-90,140800,141300,16760,689740,671740,OK
388.99895,delay,Tick,1567,1477,90,-90,140800,141300,16760,689740,671740,OK
389.291406,delay,Tick,1567,1477,90,-90,140900,141300,16760,689740,671740,OK
389.492026,delay,Tick,1567,1477,90,-90,140900,141300,16760,689740,671740,OK
389.718882,delay,Tick,1567,1477,90,-90,140900,141200,16760,689740,671740,OK
389.95394,delay,Tick,1567,1477,90,-90,140900,141200,16760,689740,671740,OK
390.30006,delay,Tick,1567,1477,90,-90,140900,141200,16760,689740,671740,OK
390.467675,delay,Tick,1567,1477,90,-90,140600,141200,16760,689740,671740,OK
390.754071,delay,Tick,1567,1477,90,-90,140600,141200,16760,689740,671740,OK
390.995148,delay,Tick,1567,1477,90,-90,140600,141200,16760,689740,671740,OK
391.244995,delay,Tick,1567,1477,90,-90,140600,141200,16760,689740,671740,OK
391.480555,delay,Tick,1567,1477,90,-90,140600,141200,16760,689740,671740,OK
391.777777,delay,Tick,1567,1477,90,-90,140500,141200,16760,689740,671740,OK
391.972688,delay,Tick,1567,1477,90,-90,140500,141200,16760,689740,671740,OK
392.267049,delay,Tick,1567,1477,90,-90,140500,141100,16760,689740,671740,OK
392.545851,delay,Tick,1567,1477,90,-90,140500,141100,16760,689740,671740,OK
392.70346,delay,Tick,1567,1477,90,-90,140500,141100,16760,689740,671740,OK
393.033248,delay,Tick,1567,1477,90,-90,140500,141100,16760,689740,671740,OK
393.209213,delay,Tick,1567,1477,90,-90,140500,141100,16760,689740,671740,OK
393.510229,delay,Tick,1567,1477,90,-90,140500,141100,16760,689740,671740,OK
393.786545,delay,Tick,1567,1477,90,-90,140500,141100,16760,689740,671740,OK
393.975474,delay,Tick,1567,1477,90,-90,140500,141100,16760,689740,671740,OK
394.215799,delay,Tick,1567,1477,90,-90,140600,141100,16760,689740,671740,OK
394.477421,delay,Tick,1567,1477,90,-90,140600,141100,16760,689740,671740,OK
394.752704,delay,Tick,1567,1477,90,-90,140600,141100,16760,689740,671740,OK
395.040429,delay,Tick,1567,1477,90,-90,140600,141100,16760,689740,671740,OK
395.294721,delay,Tick,1567,1477,90,-90,140600,141100,16760,689740,671740,OK
395.537811,delay,Tick,1567,1477,90,-90,140600,141100,16760,689740,671740,OK
395.789406,delay,Tick,1567,1477,90,-90,140700,141100,16760,689740,671740,OK
396.033964,delay,Tick,1567,1477,90,-90,140900,141400,16760,689740,671740,OK
396.28,delay,Tick,1567,1477,90,-90,140900,141400,16760,689740,671740,OK
396.536646,delay,Tick,1567,1477,90,-90,140900,141400,16760,689740,671740,OK
396.720165,delay,Tick,1567,1477,90,-90,140900,141400,16760,689740,671740,OK
397.044717,delay,Tick,1567,1477,90,-90,140900,141400,16760,689740,671740,OK
397.241561,delay,Tick,1567,1477,90,-90,140900,141400,16760,689740,671740,OK
397.503415,delay,Tick,1567,1477,90,-90,140900,141400,16760,689740,671740,OK
397.767136,delay,Tick,1567,1477,90,-90,140900,141600,16760,689740,671740,OK
397.972745,delay,Tick,1567,1477,90,-90,140900,141600,16760,689740,671740,OK
398.263555,delay,Tick,1567,1477,90,-90,141000,141600,16760,689740,671740,OK
398.513175,delay,Tick,1567,1477,90,-90,141000,141600,16760,689740,671740,OK
398.772149,delay,Tick,1567,1477,90,-90,141000,141600,16760,689740,671740,OK
398.980659,delay,Tick,1567,1477,90,-90,141000,141600,16760,689740,671740,OK
399.245374,delay,Tick,1567,1477,90,-90,141100,141600,16760,689740,671740,OK
399.469848,delay,Tick,1567,1477,90,-90,141100,141600,16760,689740,671740,OK
399.783278,delay,Tick,1567,1477,90,-90,141100,141500,16760,689740,671740,OK
399.971094,delay,Tick,1567,1477,90,-90,141100,141500,16760,689740,671740,OK
400.288366,delay,Tick,1567,1477,90,-90,141100,142200,16760,689740,671740,OK
400.55151,delay,Tick,1567,1477,90,-90,141400,142200,16760,689740,671740,OK
400.70526,delay,Tick,1567,1477,90,-90,141400,142200,16760,689740,671740,OK
400.976573,delay,Tick,1567,1477,90,-90,141400,142200,16760,689740,671740,OK
401.289747,delay,Tick,1567,1477,90,-90,141500,142000,16760,689740,671740,OK
401.4818,delay,Tick,1567,1477,90,-90,141500,142000,16760,689740,671740,OK
401.788662,delay,Tick,1567,1477,90,-90,141500,142000,16760,689740,671740,OK
402.043533,delay,Tick,1567,1477,90,-90,141500,142000,16760,689740,671740,OK
402.297088,delay,Tick,1567,1477,90,-90,141700,142200,16760,689740,671740,OK
402.500127,delay,Tick,1567,1477,90,-90,141700,142200,16760,689740,671740,OK
402.739947,delay,Tick,1567,1477,90,-90,141700,142200,16760,689740,671740,OK
402.953715,delay,Tick,1567,1477,90,-90,141700,142200,16760,689740,671740,OK
403.266273,delay,Tick,1567,1477,90,-90,141700,142200,16760,689740,671740,OK
403.527768,delay,Tick,1567,1477,90,-90,141700,142200,16760,689740,671740,OK
403.734343,delay,Tick,1567,1477,90,-90,141700,142200,16760,689740,671740,OK
404.024559,delay,Tick,1567,1477,90,-90,141700,142200,16760,689740,671740,OK
404.222514,delay,Tick,1567,1477,90,-90,141700,142200,16760,689740,671740,OK
404.466959,delay,Tick,1567,1477,90,-90,141700,142200,16760,689740,671740,OK
404.717673,delay,Tick,1567,1477,90,-90,141700,142200,16760,689740,671740,OK
404.988453,delay,Tick,1567,1477,90,-90,141700,142200,16760,689740,671740,OK
405.282445,delay,Tick,1567,1477,90,-90,141700,142200,16760,689740,671740,OK
405.514949,delay,Tick,1567,1477,90,-90,141700,142200,16760,689740,671740,OK
405.758101,delay,Tick,1567,1477,90,-90,141600,142100,16760,689740,671740,OK
406.050673,delay,Tick,1567,1477,90,-90,141600,142100,16760,689740,671740,OK
406.281869,delay,Tick,1567,1477,90,-90,141600,142100,16760,689740,671740,OK
406.479657,delay,Tick,1567,1477,90,-90,141600,142100,16760,689740,671740,OK
406.702202,delay,Tick,1567,1477,90,-90,141600,142300,16760,689740,671740,OK
407.035796,delay,Tick,1567,1477,90,-90,141600,142300,16760,689740,671740,OK
407.297505,delay,Tick,1567,1477,90,-90,141600,142200,16760,689740,671740,OK
407.479151,delay,Tick,1567,1477,90,-90,141600,142200,16760,689740,671740,OK
407.770207,delay,Tick,1567,1477,90,-90,141600,142200,16760,689740,671740,OK
408.022307,delay,Tick,1567,1477,90,-90,141600,142200,16760,689740,671740,OK
408.219705,delay,Tick,1567,1477,90,-90,141600,142100,16760,689740,671740,OK
408.534472,delay,Tick,1567,1477,90,-90,141600,142100,16760,689740,671740,OK
408.748414,delay,Tick,1567,1477,90,-90,141600,142100,16760,689740,671740,OK
408.987529,delay,Tick,1567,1477,90,-90,141600,142100,16760,689740,671740,OK
409.233646,delay,Tick,1567,1477,90,-90,141600,142100,16760,689740,671740,OK
409.542773,delay,Tick,1567,1477,90,-90,141600,142100,16760,689740,671740,OK
409.795599,delay,Tick,1567,1477,90,-90,141600,142100,16760,689740,671740,OK
409.981537,delay,Tick,1567,1477,90,-90,141600,142100,16760,689740,671740,OK
410.268265,delay,Tick,1567,1477,90,-90,141600,142100,16760,689740,671740,OK
410.538622,delay,Tick,1567,1477,90,-90,141600,142100,16760,689740,671740,OK
410.741701,delay,Tick,1567,1477,90,-90,141600,142100,16760,689740,671740,OK
411.037953,delay,Tick,1567,1477,90,-90,141600,142100,16760,689740,671740,OK
411.237839,delay,Tick,1567,1477,90,-90,141600,142100,16760,689740,671740,OK
411.472454,delay,Tick,1567,1477,90,-90,141600,142100,16760,689740,671740,OK
411.705711,delay,Tick,1567,1477,90,-90,141600,142100,16760,689740,671740,OK
412.047274,delay,Tick,1567,1477,90,-90,141600,142100,16760,689740,671740,OK
412.276684,delay,Tick,1567,1477,90,-90,141600,142100,16760,689740,671740,OK
412.517601,delay,Tick,1567,1477,90,-90,141600,142100,16760,689740,671740,OK
412.763904,delay,Tick,1567,1477,90,-90,141600,142100,16760,689740,671740,OK
412.974031,delay,Tick,1567,1477,90,-90,141600,142100,16760,689740,671740,OK
413.201475,delay,Tick,1567,1477,90,-90,141600,142100,16760,689740,671740,OK
413.477498,delay,Tick,1567,1477,90,-90,141600,142100,16760,689740,671740,OK
413.793365,delay,Tick,1567,1477,90,-90,141600,142100,16760,689740,671740,OK
414.027912,delay,Tick,1567,1477,90,-90,141600,142100,16760,689740,671740,OK
414.289528,delay,Tick,1567,1477,90,-90,141600,142000,16760,689740,671740,OK
414.450973,delay,Tick,1567,1477,90,-90,141600,142000,16760,689740,671740,OK
414.75546,delay,Tick,1567,1477,90,-90,141600,142000,16760,689740,671740,OK
414.965953,delay,Tick,1567,1477,90,-90,142000,142000,16760,689740,689740,OK
415.287899,delay,Tick,1567,1477,90,-90,142000,142000,16760,689740,689740,OK
415.547807,delay,Tick,1567,1477,90,-90,142000,142000,16760,689740,689740,OK
415.754335,delay,Tick,1567,1477,90,-90,142000,142200,16760,689740,671740,OK
415.978509,delay,Tick,1567,1477,90,-90,142000,142200,16760,689740,671740,OK
416.291397,delay,Tick,1567,1477,90,-90,142000,142200,16760,689740,671740,OK
416.4605,delay,Tick,1567,1477,90,-90,142000,142200,16760,689740,671740,OK
416.785903,delay,Tick,1567,1477,90,-90,142100,142200,16760,689740,680740,OK
417.033756,delay,Tick,1567,1477,90,-90,142100,142200,16760,689740,680740,OK
417.282489,delay,Tick,1567,1477,90,-90,142100,142200,16760,689740,680740,OK
417.531109,delay,Tick,1567,1477,90,-90,142100,142200,16760,689740,680740,OK
417.771818,delay,Tick,1567,1477,90,-90,142100,142200,16760,689740,680740,OK
417.987609,delay,Tick,1567,1477,90,-90,142100,142200,16760,689740,680740,OK
418.234872,delay,Tick,1567,1477,90,-90,142100,142200,16760,689740,680740,OK
418.538867,delay,Tick,1567,1477,90,-90,142100,142200,16760,689740,680740,OK
418.783373,delay,Tick,1567,1477,90,-90,142100,142200,16760,689740,680740,OK
418.954781,delay,Tick,1567,1477,90,-90,142100,142200,16760,689740,680740,OK
419.231567,delay,Tick,1567,1477,90,-90,142100,142200,16760,689740,680740,OK
419.547645,delay,Tick,1567,1477,90,-90,142100,142200,16760,689740,680740,OK
419.704182,delay,Tick,1567,1477,90,-90,142100,142200,16760,689740,680740,OK
419.989951,delay,Tick,1567,1477,90,-90,142100,142200,16760,689740,680740,OK
420.251269,delay,Tick,1567,1477,90,-90,142100,142200,16760,689740,680740,OK
420.540825,delay,Tick,1567,1477,90,-90,142100,142200,16760,689740,680740,OK
420.792418,delay,Tick,1567,1477,90,-90,142100,142200,16760,689740,680740,OK
420.986968,delay,Tick,1567,1477,90,-90,142100,142200,16760,689740,680740,OK
421.27445,delay,Tick,1567,1477,90,-90,142100,142200,16760,689740,680740,OK
421.529267,delay,Tick,1567,1477,90,-90,142100,142200,16760,689740,680740,OK
421.779171,delay,Tick,1567,1477,90,-90,142100,142200,16760,689740,680740,OK
422.014536,delay,Tick,1567,1477,90,-90,142100,142200,16760,689740,680740,OK
422.228327,delay,Tick,1567,1477,90,-90,141600,142200,16760,689740,671740,OK
422.551866,delay,Tick,1567,1477,90,-90,142100,142200,16760,689740,680740,OK
422.76838,delay,Tick,1567,1477,90,-90,142100,142200,16760,689740,680740,OK
423.019954,delay,Tick,1567,1477,90,-90,142100,142200,16760,689740,680740,OK
423.211847,delay,Tick,1567,1477,90,-90,142100,142200,16760,689740,680740,OK
423.457902,delay,Tick,1567,1477,90,-90,142100,142200,16760,689740,680740,OK
423.785864,delay,Tick,1567,1477,90,-90,142200,142100,16760,689740,698740,OK
424.007501,delay,Tick,1567,1477,90,-90,142200,142100,16760,689740,698740,OK
424.252974,delay,Tick,1567,1477,90,-90,142200,142100,16760,689740,698740,OK
424.48501,delay,Tick,1567,1477,90,-90,142200,142100,16760,689740,698740,OK
424.771188,delay,Tick,1567,1477,90,-90,142200,142100,16760,689740,698740,OK
425.04439,delay,Tick,1567,1477,90,-90,142200,142200,16760,689740,689740,OK
425.227713,delay,Tick,1567,1477,90,-90,142200,142200,16760,689740,689740,OK
425.49983,delay,Tick,1567,1477,90,-90,142200,142200,16760,689740,689740,OK
425.714728,delay,Tick,1567,1477,90,-90,142200,142200,16760,689740,689740,OK
425.957026,delay,Tick,1567,1477,90,-90,142200,142200,16760,689740,689740,OK
426.250105,delay,Tick,1567,1477,90,-90,142200,142300,16760,689740,680740,OK
426.476277,delay,Tick,1567,1477,90,-90,141800,142300,16760,689740,671740,OK
426.795924,delay,Tick,1567,1477,90,-90,141800,142200,16760,689740,671740,OK
427.037079,delay,Tick,1567,1477,90,-90,142000,142200,16760,689740,671740,OK
427.205209,delay,Tick,1567,1477,90,-90,142000,142200,16760,689740,671740,OK
427.528404,delay,Tick,1567,1477,90,-90,142000,142200,16760,689740,671740,OK
427.743673,delay,Tick,1567,1477,90,-90,142000,142200,16760,689740,671740,OK
427.980086,delay,Tick,1567,1477,90,-90,142000,142200,16760,689740,671740,OK
428.276178,delay,Tick,1567,1477,90,-90,142000,142300,16760,689740,671740,OK
428.518076,delay,Tick,1567,1477,90,-90,142000,142300,16760,689740,671740,OK
428.783135,delay,Tick,1567,1477,90,-90,142000,142300,16760,689740,671740,OK
428.98673,delay,Tick,1567,1477,90,-90,141800,142300,16760,689740,671740,OK
429.299289,delay,Tick,1567,1477,90,-90,141800,142300,16760,689740,671740,OK
429.49508,delay,Tick,1567,1477,90,-90,141800,142300,16760,689740,671740,OK
429.709391,delay,Tick,1567,1477,90,-90,141800,142500,16760,689740,671740,OK
429.996589,delay,Tick,1567,1477,90,-90,142000,142500,16760,689740,671740,OK
430.28786,delay,Tick,1567,1477,90,-90,142000,142500,16760,689740,671740,OK
430.471187,delay,Tick,1567,1477,90,-90,142000,142500,16760,689740,671740,OK
430.777429,delay,Tick,1567,1477,90,-90,142000,142500,16760,689740,671740,OK
430.983574,delay,Tick,1567,1477,90,-90,142200,142500,16760,689740,671740,OK
431.209293,delay,Tick,1567,1477,90,-90,142200,142500,16760,689740,671740,OK
431.473439,delay,Tick,1567,1477,90,-90,142200,142500,16760,689740,671740,OK
431.729988,delay,Tick,1567,1477,90,-90,142200,142500,16760,689740,671740,OK
431.981846,delay,Tick,1567,1477,90,-90,141600,142200,16760,689740,671740,OK
432.237161,delay,Tick,1567,1477,90,-90,141600,142200,16760,689740,671740,OK
432.540336,delay,Tick,1567,1477,90,-90,141600,142200,16760,689740,671740,OK
432.765627,delay,Tick,1567,1477,90,-90,141600,142200,16760,689740,671740,OK
433.010304,delay,Tick,1567,1477,90,-90,141600,142200,16760,689740,671740,OK
433.22863,delay,Tick,1567,1477,90,-90,141600,142200,16760,689740,671740,OK
433.460363,delay,Tick,1567,1477,90,-90,141600,142300,16760,689740,671740,OK
433.757672,delay,Tick,1567,1477,90,-90,142100,142300,16760,689740,671740,OK
434.016569,delay,Tick,1567,1477,90,-90,142100,142300,16760,689740,671740,OK
434.298833,delay,Tick,1567,1477,90,-90,142200,142300,16760,689740,680740,OK
434.501687,delay,Tick,1567,1477,90,-90,142200,142300,16760,689740,680740,OK
434.779159,delay,Tick,1567,1477,90,-90,142200,142300,16760,689740,680740,OK
435.029378,delay,Tick,1567,1477,90,-90,142200,142500,16760,689740,671740,OK
435.268451,delay,Tick,1567,1477,90,-90,142200,142600,16760,689740,671740,OK
435.49437,delay,Tick,1567,1477,90,-90,142200,142600,16760,689740,671740,OK
435.702044,delay,Tick,1567,1477,90,-90,142200,142600,16760,689740,671740,OK
436.013993,delay,Tick,1567,1477,90,-90,142200,142600,16760,689740,671740,OK
436.257867,delay,Tick,1567,1477,90,-90,142200,142600,16760,689740,671740,OK
436.46192,delay,Tick,1567,1477,90,-90,142200,142700,16760,689740,671740,OK
436.791351,delay,Tick,1567,1477,90,-90,142200,142700,16760,689740,671740,OK
436.981228,delay,Tick,1567,1477,90,-90,142200,142700,16760,689740,671740,OK
437.233936,delay,Tick,1567,1477,90,-90,142200,142700,16760,689740,671740,OK
437.480809,delay,Tick,1567,1477,90,-90,142200,142700,16760,689740,671740,OK
437.746446,delay,Tick,1567,1477,90,-90,142200,142700,16760,689740,671740,OK
437.956245,delay,Tick,1567,1477,90,-90,142200,142700,16760,689740,671740,OK
438.280904,delay,Tick,1567,1477,90,-90,142200,142700,16760,689740,671740,OK
438.498331,delay,Tick,1567,1477,90,-90,142300,142700,16760,689740,671740,OK
438.798166,delay,Tick,1567,1477,90,-90,142300,142700,16760,689740,671740,OK
439.021428,delay,Tick,1567,1477,90,-90,142300,142700,16760,689740,671740,OK
439.256172,delay,Tick,1567,1477,90,-90,142300,142700,16760,689740,671740,OK
439.542848,delay,Tick,1567,1477,90,-90,142300,142800,16760,689740,671740,OK
439.717242,delay,Tick,1567,1477,90,-90,142300,142800,16760,689740,671740,OK
440.048478,delay,Tick,1567,1477,90,-90,142300,142800,16760,689740,671740,OK
440.241437,delay,Tick,1567,1477,90,-90,142300,142800,16760,689740,671740,OK
440.54902,delay,Tick,1567,1477,90,-90,142300,142800,16760,689740,671740,OK
440.768659,delay,Tick,1567,1477,90,-90,142300,142800,16760,689740,671740,OK
440.97277,delay,Tick,1567,1477,90,-90,142300,142800,16760,689740,671740,OK
441.219874,delay,Tick,1567,1477,90,-90,142300,142800,16760,689740,671740,OK
441.536154,delay,Tick,1567,1477,90,-90,142300,142700,16760,689740,671740,OK
441.770812,delay,Tick,1567,1477,90,-90,142300,142700,16760,689740,671740,OK
442.038373,delay,Tick,1567,1477,90,-90,142300,142700,16760,689740,671740,OK
442.209091,delay,Tick,1567,1477,90,-90,142300,142700,16760,689740,671740,OK
442.520065,delay,Tick,1567,1477,90,-90,142300,142700,16760,689740,671740,OK
442.719887,delay,Tick,1567,1477,90,-90,142400,142700,16760,689740,671740,OK
442.999209,delay,Tick,1567,1477,90,-90,142400,142700,16760,689740,671740,OK
443.252066,delay,Tick,1567,1477,90,-90,142400,142700,16760,689740,671740,OK
443.513588,delay,Tick,1567,1477,90,-90,142400,142700,16760,689740,671740,OK
443.781091,delay,Tick,1567,1477,90,-90,142400,142700,16760,689740,671740,OK
444.009972,delay,Tick,1567,1477,90,-90,142400,142700,16760,689740,671740,OK
444.234121,delay,Tick,1567,1477,90,-90,142400,142700,16760,689740,671740,OK
444.530539,delay,Tick,1567,1477,90,-90,142000,142500,16760,689740,671740,OK
444.766842,delay,Tick,1567,1477,90,-90,142000,142500,16760,689740,671740,OK
445.047193,delay,Tick,1567,1477,90,-90,142000,142500,16760,689740,671740,OK
445.282523,delay,Tick,1567,1477,90,-90,142000,142500,16760,689740,671740,OK
445.451263,delay,Tick,1567,1477,90,-90,142500,142500,16760,689740,689740,OK
445.711154,delay,Tick,1567,1477,90,-90,142500,142700,16760,689740,671740,OK
446.048007,delay,Tick,1567,1477,90,-90,142500,142700,16760,689740,671740,OK
446.262859,delay,Tick,1567,1477,90,-90,142500,142700,16760,689740,671740,OK
446.477462,delay,Tick,1567,1477,90,-90,142000,142700,16760,689740,671740,OK
446.76741,delay,Tick,1567,1477,90,-90,142000,142700,16760,689740,671740,OK
446.957488,delay,Tick,1567,1477,90,-90,142000,142700,16760,689740,671740,OK
447.24412,delay,Tick,1567,1477,90,-90,142000,142700,16760,689740,671740,OK
447.55227,delay,Tick,1567,1477,90,-90,142200,142700,16760,689740,671740,OK
447.718816,delay,Tick,1567,1477,90,-90,142200,142700,16760,689740,671740,OK
448.037002,delay,Tick,1567,1477,90,-90,142200,142700,16760,689740,671740,OK
448.275283,delay,Tick,1567,1477,90,-90,142200,142700,16760,689740,671740,OK
448.543934,delay,Tick,1567,1477,90,-90,142200,142700,16760,689740,671740,OK
448.789297,delay,Tick,1567,1477,90,-90,142200,142700,16760,689740,671740,OK
448.952381,delay,Tick,1567,1477,90,-90,142200,142700,16760,689740,671740,OK
449.276164,delay,Tick,1567,1477,90,-90,142200,142700,16760,689740,671740,OK
449.479766,delay,Tick,1567,1477,90,-90,142200,142900,16760,689740,671740,OK
449.77605,delay,Tick,1567,1477,90,-90,142200,142900,16760,689740,671740,OK
449.953369,delay,Tick,1567,1477,90,-90,142200,142900,16760,689740,671740,OK
450.209956,delay,Tick,1567,1477,90,-90,142200,142900,16760,689740,671740,OK
450.511471,delay,Tick,1567,1477,90,-90,142500,142900,16760,689740,671740,OK
450.745176,delay,Tick,1567,1477,90,-90,142500,142800,16760,689740,671740,OK
451.048163,delay,Tick,1567,1477,90,-90,142500,142800,16760,689740,671740,OK
451.225314,delay,Tick,1567,1477,90,-90,142500,142800,16760,689740,671740,OK
451.506337,delay,Tick,1567,1477,90,-90,142500,142800,16760,689740,671740,OK
451.700717,delay,Tick,1567,1477,90,-90,142500,142800,16760,689740,671740,OK
451.978773,delay,Tick,1567,1477,90,-90,142500,142800,16760,689740,671740,OK
452.281033,delay,Tick,1567,1477,90,-90,142500,142800,16760,689740,671740,OK
452.544347,delay,Tick,1567,1477,90,-90,142500,142800,16760,689740,671740,OK
452.763802,delay,Tick,1567,1477,90,-90,142500,142800,16760,689740,671740,OK
452.989875,delay,Tick,1567,1477,90,-90,142500,142800,16760,689740,671740,OK
453.291842,delay,Tick,1567,1477,90,-90,142500,142800,16760,689740,671740,OK
453.518757,delay,Tick,1567,1477,90,-90,142500,142800,16760,689740,671740,OK
453.765119,delay,Tick,1567,1477,90,-90,142500,142800,16760,689740,671740,OK
454.017466,delay,Tick,1567,1477,90,-90,142500,142800,16760,689740,671740,OK
454.273358,delay,Tick,1567,1477,90,-90,142700,143000,16760,689740,671740,OK
454.54515,delay,Tick,1567,1477,90,-90,142700,143000,16760,689740,671740,OK
454.744782,delay,Tick,1567,1477,90,-90,142700,143000,16760,689740,671740,OK
455.030726,delay,Tick,1567,1477,90,-90,142600,143000,16760,689740,671740,OK
455.296262,delay,Tick,1567,1477,90,-90,142600,143000,16760,689740,671740,OK
455.532437,delay,Tick,1567,1477,90,-90,142600,143000,16760,689740,671740,OK
455.753216,delay,Tick,1567,1477,90,-90,142600,143000,16760,689740,671740,OK
456.041584,delay,Tick,1567,1477,90,-90,142600,143000,16760,689740,671740,OK
456.249482,delay,Tick,1567,1477,90,-90,142600,143000,16760,689740,671740,OK
456.456605,delay,Tick,1567,1477,90,-90,142600,143000,16760,689740,671740,OK
456.749326,delay,Tick,1567,1477,90,-90,142600,143000,16760,689740,671740,OK
456.965007,delay,Tick,1567,1477,90,-90,142600,143000,16760,689740,671740,OK
457.206308,delay,Tick,1567,1477,90,-90,142600,143000,16760,689740,671740,OK
457.53349,delay,Tick,1567,1477,90,-90,142600,143000,16760,689740,671740,OK
457.758302,delay,Tick,1567,1477,90,-90,142600,143000,16760,689740,671740,OK
458.022487,delay,Tick,1567,1477,90,-90,142600,143000,16760,689740,671740,OK
458.28573,delay,Tick,1567,1477,90,-90,142700,143000,16760,689740,671740,OK
458.516814,delay,Tick,1567,1477,90,-90,142700,143000,16760,689740,671740,OK
458.730419,delay,Tick,1567,1477,90,-90,142400,143000,16760,689740,671740,OK
458.975322,delay,Tick,1567,1477,90,-90,142400,143000,16760,689740,671740,OK
459.241901,delay,Tick,1567,1477,90,-90,142400,143000,16760,689740,671740,OK
459.508201,delay,Tick,1567,1477,90,-90,142400,143000,16760,689740,671740,OK
459.775029,delay,Tick,1567,1477,90,-90,142400,143000,16760,689740,671740,OK
459.99714,delay,Tick,1567,1477,90,-90,142400,143000,16760,689740,671740,OK
460.291726,delay,Tick,1567,1477,90,-90,142400,143000,16760,689740,671740,OK
460.523076,delay,Tick,1567,1477,90,-90,142400,143000,16760,689740,671740,OK
460.785784,delay,Tick,1567,1477,90,-90,142400,143000,16760,689740,671740,OK
460.963066,delay,Tick,1567,1477,90,-90,142400,143000,16760,689740,671740,OK
461.244913,delay,Tick,1567,1477,90,-90,142200,142900,16760,689740,671740,OK
461.53697,delay,Tick,1567,1477,90,-90,142200,142900,16760,689740,671740,OK
461.765312,delay,Tick,1567,1477,90,-90,142700,142900,16760,689740,671740,OK
461.99929,delay,Tick,1567,1477,90,-90,142700,142900,16760,689740,671740,OK
462.226582,delay,Tick,1567,1477,90,-90,142700,142900,16760,689740,671740,OK
462.543807,delay,Tick,1567,1477,90,-90,142700,142900,16760,689740,671740,OK
462.798401,delay,Tick,1567,1477,90,-90,142200,142900,16760,689740,671740,OK
463.034897,delay,Tick,1567,1477,90,-90,142200,142900,16760,689740,671740,OK
463.212,delay,Tick,1567,1477,90,-90,142300,142900,16760,689740,671740,OK
463.454805,delay,Tick,1567,1477,90,-90,142300,142900,16760,689740,671740,OK
463.771861,delay,Tick,1567,1477,90,-90,142300,142900,16760,689740,671740,OK
464.026847,delay,Tick,1567,1477,90,-90,142300,142900,16760,689740,671740,OK
464.298099,delay,Tick,1567,1477,90,-90,142300,142900,16760,689740,671740,OK
464.541855,delay,Tick,1567,1477,90,-90,142300,142900,16760,689740,671740,OK
464.783034,delay,Tick,1567,1477,90,-90,142300,142900,16760,689740,671740,OK
465.025192,delay,Tick,1567,1477,90,-90,142300,142900,16760,689740,671740,OK
465.20639,delay,Tick,1567,1477,90,-90,142300,142800,16760,689740,671740,OK
465.538334,delay,Tick,1567,1477,90,-90,142300,142700,16760,689740,671740,OK
465.790893,delay,Tick,1567,1477,90,-90,142300,142700,16760,689740,671740,OK
465.998312,delay,Tick,1567,1477,90,-90,142300,142800,16760,689740,671740,OK
466.286446,delay,Tick,1567,1477,90,-90,142300,142800,16760,689740,671740,OK
466.541831,delay,Tick,1567,1477,90,-90,142300,142900,16760,689740,671740,OK
466.743127,delay,Tick,1567,1477,90,-90,142300,142900,16760,689740,671740,OK
467.042851,delay,Tick,1567,1477,90,-90,142300,143100,16760,689740,671740,OK
467.218599,delay,Tick,1567,1477,90,-90,142300,143100,16760,689740,671740,OK
467.524104,delay,Tick,1567,1477,90,-90,142700,143300,16760,689740,671740,OK
467.747016,delay,Tick,1567,1477,90,-90,142700,143300,16760,689740,671740,OK
468.012037,delay,Tick,1567,1477,90,-90,142700,143300,16760,689740,671740,OK
468.261227,delay,Tick,1567,1477,90,-90,142700,143300,16760,689740,671740,OK
468.487493,delay,Tick,1567,1477,90,-90,142700,143300,16760,689740,671740,OK
468.722685,delay,Tick,1567,1477,90,-90,142700,143300,16760,689740,671740,OK
468.998882,delay,Tick,1567,1477,90,-90,142600,143300,16760,689740,671740,OK
469.247628,delay,Tick,1567,1477,90,-90,142600,143300,16760,689740,671740,OK
469.502942,delay,Tick,1567,1477,90,-90,142600,143300,16760,689740,671740,OK
469.775932,delay,Tick,1567,1477,90,-90,142600,143200,16760,689740,671740,OK
469.996541,delay,Tick,1567,1477,90,-90,142600,143200,16760,689740,671740,OK
470.254039,delay,Tick,1567,1477,90,-90,142600,143200,16760,689740,671740,OK
470.488802,delay,Tick,1567,1477,90,-90,142600,143200,16760,689740,671740,OK
470.736564,delay,Tick,1567,1477,90,-90,142600,143200,16760,689740,671740,OK
470.989447,delay,Tick,1567,1477,90,-90,142600,143200,16760,689740,671740,OK
471.294276,delay,Tick,1567,1477,90,-90,142600,143200,16760,689740,671740,OK
471.483938,delay,Tick,1567,1477,90,-90,142600,143200,16760,689740,671740,OK
471.745046,delay,Tick,1567,1477,90,-90,142600,143200,16760,689740,671740,OK
472.027844,delay,Tick,1567,1477,90,-90,142600,143200,16760,689740,671740,OK
472.249253,delay,Tick,1567,1477,90,-90,142600,143200,16760,689740,671740,OK
472.495911,delay,Tick,1567,1477,90,-90,142800,143200,16760,689740,671740,OK
472.74373,delay,Tick,1567,1477,90,-90,142800,143200,16760,689740,671740,OK
473.040489,delay,Tick,1567,1477,90,-90,142800,143200,16760,689740,671740,OK
473.240141,delay,Tick,1567,1477,90,-90,142800,143200,16760,689740,671740,OK
473.541624,delay,Tick,1567,1477,90,-90,142800,143200,16760,689740,671740,OK
473.738849,delay,Tick,1567,1477,90,-90,142800,143200,16760,689740,671740,OK
474.017875,delay,Tick,1567,1477,90,-90,142800,143200,16760,689740,671740,OK
474.226813,delay,Tick,1567,1477,90,-90,142800,143200,16760,689740,671740,OK
474.543678,delay,Tick,1567,1477,90,-90,142800,143200,16760,689740,671740,OK
474.742889,delay,Tick,1567,1477,90,-90,142800,143200,16760,689740,671740,OK
474.961267,delay,Tick,1567,1477,90,-90,142800,143200,16760,689740,671740,OK
475.209535,delay,Tick,1567,1477,90,-90,142900,143200,16760,689740,671740,OK
475.518961,delay,Tick,1567,1477,90,-90,142900,143200,16760,689740,671740,OK
475.78876,delay,Tick,1567,1477,90,-90,142800,143200,16760,689740,671740,OK
476.043755,delay,Tick,1567,1477,90,-90,142800,143300,16760,689740,671740,OK
476.22966,delay,Tick,1567,1477,90,-90,142900,143300,16760,689740,671740,OK
476.539703,delay,Tick,1567,1477,90,-90,142900,143300,16760,689740,671740,OK
476.716568,delay,Tick,1567,1477,90,-90,142900,143300,16760,689740,671740,OK
477.036179,delay,Tick,1567,1477,90,-90,142900,143300,16760,689740,671740,OK
477.229766,delay,Tick,1567,1477,90,-90,142900,143300,16760,689740,671740,OK
477.459713,delay,Tick,1567,1477,90,-90,142900,143400,16760,689740,671740,OK
477.732132,delay,Tick,1567,1477,90,-90,142900,143300,16760,689740,671740,OK
477.963836,delay,Tick,1567,1477,90,-90,142900,143300,16760,689740,671740,OK
478.263733,delay,Tick,1567,1477,90,-90,142900,143300,16760,689740,671740,OK
478.548451,delay,Tick,1567,1477,90,-90,142900,143300,16760,689740,671740,OK
478.765486,delay,Tick,1567,1477,90,-90,142600,143100,16760,689740,671740,OK
478.968313,delay,Tick,1567,1477,90,-90,142900,142900,16760,689740,689740,OK
479.215713,delay,Tick,1567,1477,90,-90,142900,142900,16760,689740,689740,OK
479.491528,delay,Tick,1567,1477,90,-90,142900,142900,16760,689740,689740,OK
479.740324,delay,Tick,1567,1477,90,-90,142900,142900,16760,689740,689740,OK
479.96785,delay,Tick,1567,1477,90,-90,142900,142900,16760,689740,689740,OK
480.255537,delay,Tick,1567,1477,90,-90,142900,142700,16760,689740,707740,OK
480.517036,delay,Tick,1567,1477,90,-90,142900,142700,16760,689740,707740,OK
480.75012,delay,Tick,1567,1477,90,-90,142900,142700,16760,689740,707740,OK
481.036222,delay,Tick,1567,1477,90,-90,142900,142700,16760,689740,707740,OK
481.223736,delay,Tick,1567,1477,90,-90,143000,142700,16760,689740,707740,OK
481.464587,delay,Tick,1567,1477,90,-90,143000,142700,16760,689740,707740,OK
481.797775,delay,Tick,1567,1477,90,-90,143000,142700,16760,689740,707740,OK
481.95137,delay,Tick,1567,1477,90,-90,143000,142700,16760,689740,707740,OK
482.218055,delay,Tick,1567,1477,90,-90,143000,142800,16760,689740,707740,OK
482.476377,delay,Tick,1567,1477,90,-90,143000,142800,16760,689740,707740,OK
482.726445,delay,Tick,1567,1477,90,-90,143000,142800,16760,689740,707740,OK
482.981414,delay,Tick,1567,1477,90,-90,143000,142800,16760,689740,707740,OK
483.206275,delay,Tick,1567,1477,90,-90,143000,142800,16760,689740,707740,OK
483.530273,delay,Tick,1567,1477,90,-90,143000,142800,16760,689740,707740,OK
483.772294,delay,Tick,1567,1477,90,-90,143000,142800,16760,689740,707740,OK
484.036321,delay,Tick,1567,1477,90,-90,143000,142800,16760,689740,707740,OK
484.285994,delay,Tick,1567,1477,90,-90,143000,142800,16760,689740,707740,OK
484.545893,delay,Tick,1567,1477,90,-90,143000,142800,16760,689740,707740,OK
484.733659,delay,Tick,1567,1477,90,-90,143000,142800,16760,689740,707740,OK
484.974415,delay,Tick,1567,1477,90,-90,143000,142800,16760,689740,707740,OK
485.262775,delay,Tick,1567,1477,90,-90,143000,143000,16760,689740,689740,OK
485.474785,delay,Tick,1567,1477,90,-90,143000,143000,16760,689740,689740,OK
485.729859,delay,Tick,1567,1477,90,-90,143000,142800,16760,689740,707740,OK
485.99957,delay,Tick,1567,1477,90,-90,143000,142800,16760,689740,707740,OK
486.275495,delay,Tick,1567,1477,90,-90,143000,142800,16760,689740,707740,OK
486.513466,delay,Tick,1567,1477,90,-90,143000,142800,16760,689740,707740,OK
486.709918,delay,Tick,1567,1477,90,-90,143000,142800,16760,689740,707740,OK
487.024958,delay,Tick,1567,1477,90,-90,143000,142800,16760,689740,707740,OK
487.236755,delay,Tick,1567,1477,90,-90,143000,142800,16760,689740,707740,OK
487.53123,delay,Tick,1567,1477,90,-90,142800,142800,16760,689740,689740,OK
487.709463,delay,Tick,1567,1477,90,-90,142800,142800,16760,689740,689740,OK
488.0487,delay,Tick,1567,1477,90,-90,142800,142800,16760,689740,689740,OK
488.242395,delay,Tick,1567,1477,90,-90,142800,142800,16760,689740,689740,OK
488.536861,delay,Tick,1567,1486,81,-81,142900,142800,16631,691669,699769,OK
488.773118,delay,Tick,1567,1486,81,-81,142900,142800,16631,691669,699769,OK
488.98215,delay,Tick,1567,1486,81,-81,142900,142800,16631,691669,699769,OK
489.27803,delay,Tick,1567,1486,81,-81,142900,142800,16631,691669,699769,OK
489.490058,delay,Tick,1567,1486,81,-81,142900,142800,16631,691669,699769,OK
489.70413,delay,Tick,1567,1486,81,-81,142900,142800,16631,691669,699769,OK
490.010765,delay,Tick,1567,1486,81,-81,142900,142800,16631,691669,699769,OK
490.277982,delay,Tick,1567,1486,81,-81,142900,142600,16631,691669,707869,OK
490.534006,delay,Tick,1567,1486,81,-81,142900,142600,16631,691669,707869,OK
490.703402,delay,Tick,1567,1486,81,-81,142900,142600,16631,691669,707869,OK
491.047627,delay,Tick,1567,1486,81,-81,142900,142600,16631,691669,707869,OK
491.270212,delay,Tick,1567,1486,81,-81,142900,142600,16631,691669,707869,OK
491.545404,delay,Tick,1567,1486,81,-81,142900,142600,16631,691669,707869,OK
491.792628,delay,Tick,1567,1486,81,-81,142900,142600,16631,691669,707869,OK
491.995346,delay,Tick,1567,1486,81,-81,142900,142600,16631,691669,707869,OK
492.285793,delay,Tick,1567,1486,81,-81,142900,142500,16631,691669,707869,OK
492.507239,delay,Tick,1567,1486,81,-81,142900,142400,16631,691669,707869,OK
492.72936,delay,Tick,1567,1549,18,-18,142200,142400,18428,702472,698872,OK
492.97475,delay,Tick,1567,1549,18,-18,142200,142400,18428,702472,698872,OK
493.213434,delay,Tick,1567,1549,18,-18,142200,142400,18428,702472,698872,OK
493.469421,delay,Tick,1567,1549,18,-18,142200,142400,18428,702472,698872,OK
493.804002,delay,Tick,1567,1549,18,-18,142200,142700,18428,702472,698872,OK
494.028767,delay,Tick,1567,1549,18,-18,142200,142700,18428,702472,698872,OK
494.292342,delay,Tick,1567,1549,18,-18,142200,142800,18428,702472,698872,OK
494.533008,delay,Tick,1567,1549,18,-18,142200,142800,18428,702472,698872,OK
494.737844,delay,Tick,1567,1549,18,-18,142200,142900,18428,702472,698872,OK
495.030693,delay,Tick,1577,1549,28,-28,142200,143000,18285,704615,699015,OK
495.283881,delay,Tick,1577,1549,28,-28,142200,143000,18285,704615,699015,OK
495.522459,delay,Tick,1577,1549,28,-28,142200,143000,18285,704615,699015,OK
495.789412,delay,Tick,1577,1549,28,-28,142200,143000,18285,704615,699015,OK
495.977908,delay,Tick,1577,1549,28,-28,142200,143000,18285,704615,699015,OK
496.27942,delay,Tick,1587,1549,38,-38,142200,142800,18142,706758,699158,OK
496.519153,delay,Tick,1587,1549,38,-38,142200,142800,18142,706758,699158,OK
496.729694,delay,Tick,1592,1549,43,-43,142600,143000,18071,708329,699729,OK
496.974086,delay,Tick,1592,1549,43,-43,142600,143000,18071,708329,699729,OK
497.252644,delay,Tick,1592,1549,43,-43,142600,143000,18071,708329,699729,OK
497.532116,delay,Tick,1592,1549,43,-43,142600,143000,18071,708329,699729,OK
497.710806,delay,Tick,1602,1549,53,-53,142400,143000,17928,710472,699872,OK
498.040902,delay,Tick,1602,1549,53,-53,142400,143000,17928,710472,699872,OK
498.264201,delay,Tick,1602,1549,53,-53,142400,143000,17928,710472,699872,OK
498.463665,delay,Tick,1602,1549,53,-53,142400,142900,17928,710472,699872,OK
498.78245,delay,Tick,1602,1549,53,-53,142400,142900,17928,710472,699872,OK
498.995063,delay,Tick,1612,1549,63,-63,142200,142900,17786,712614,700014,OK
499.205148,delay,Tick,1612,1549,63,-63,142200,142900,17786,712614,700014,OK
499.483102,delay,Tick,1612,1549,63,-63,142200,142900,17786,712614,700014,OK
499.791267,delay,Tick,1612,1549,63,-63,142200,142900,17786,712614,700014,OK
500.020038,delay,Tick,1612,1549,63,-63,142200,142900,17786,712614,700014,OK
500.232908,delay,Tick,1612,1549,63,-63,142200,142700,17786,712614,700014,OK
500.451971,delay,Tick,1612,1549,63,-63,142200,142700,17786,712614,700014,OK
500.784427,delay,Tick,1612,1549,63,-63,142200,142700,17786,712614,700014,OK
500.965833,delay,Tick,1612,1549,63,-63,142200,142700,17786,712614,700014,OK
501.226992,delay,Tick,1622,1549,73,-73,142500,142600,17644,712756,705456,OK
501.452815,delay,Tick,1622,1549,73,-73,142500,142600,17644,712756,705456,OK
501.756279,delay,Tick,1632,1549,83,-83,142100,142600,17502,714898,698298,OK
502.007991,delay,Tick,1639,1549,90,-90,142400,142600,17701,716099,698099,OK
502.229658,delay,Tick,1639,1563,76,-76,142900,142800,17501,716299,723899,OK
502.546683,delay,Tick,1639,1563,76,-76,142900,142800,17501,716299,723899,OK
502.744229,delay,Tick,1639,1563,76,-76,142900,142800,17501,716299,723899,OK
503.002769,delay,Tick,1639,1563,76,-76,142900,142800,17501,716299,723899,OK
503.228345,delay,Tick,1639,1563,76,-76,142900,142800,17501,716299,723899,OK
503.462169,delay,Tick,1639,1563,76,-76,142900,142900,17501,716299,716299,OK
503.788187,delay,Tick,1639,1563,76,-76,142900,142900,17501,716299,716299,OK
503.972957,delay,Tick,1639,1563,76,-76,142900,142900,17501,716299,716299,OK
504.293638,delay,Tick,1639,1563,76,-76,142800,142900,17501,716299,708699,OK
504.512958,delay,Tick,1639,1563,76,-76,142800,142900,17501,716299,708699,OK
504.799247,delay,Tick,1639,1563,76,-76,142800,142900,17501,716299,708699,OK
505.002118,delay,Tick,1639,1563,76,-76,142800,142900,17501,716299,708699,OK
505.225988,delay,Tick,1639,1563,76,-76,142800,142700,17501,716299,723899,OK
505.476614,delay,Tick,1639,1563,76,-76,142800,142700,17501,716299,723899,OK
505.776679,delay,Tick,1639,1563,76,-76,142800,142700,17501,716299,723899,OK
506.037025,delay,Tick,1639,1563,76,-76,142800,142700,17501,716299,723899,OK
506.28114,delay,Tick,1639,1563,76,-76,142600,142700,17501,716299,708699,OK
506.489857,delay,Tick,1639,1563,76,-76,142600,142700,17501,716299,708699,OK
506.725842,delay,Tick,1639,1563,76,-76,142600,142700,17501,716299,708699,OK
507.009785,delay,Tick,1639,1563,76,-76,142600,142700,17501,716299,708699,OK
507.271231,delay,Tick,1639,1563,76,-76,142600,142700,17501,716299,708699,OK
507.48742,delay,Tick,1639,1563,76,-76,142600,142700,17501,716299,708699,OK
507.78174,delay,Tick,1639,1563,76,-76,142600,142700,17501,716299,708699,OK
508.021187,delay,Tick,1639,1563,76,-76,142600,142700,17501,716299,708699,OK
508.234124,delay,Tick,1639,1563,76,-76,142600,142700,17501,716299,708699,OK
508.519641,delay,Tick,1639,1563,76,-76,142600,142700,17501,716299,708699,OK
508.732115,delay,Tick,1639,1563,76,-76,142600,142700,17501,716299,708699,OK
509.047543,delay,Tick,1639,1563,76,-76,142600,142700,17501,716299,708699,OK
509.275147,delay,Tick,1639,1563,76,-76,142600,142700,17501,716299,708699,OK
509.508608,delay,Tick,1639,1563,76,-76,142600,142700,17501,716299,708699,OK
509.722025,delay,Tick,1639,1573,66,-66,142900,142700,17358,718442,731642,OK
510.00399,delay,Tick,1639,1573,66,-66,142900,142700,17358,718442,731642,OK
510.294705,delay,Tick,1639,1573,66,-66,142400,142800,17358,718442,705242,OK
510.54488,delay,Tick,1639,1573,66,-66,142400,142800,17358,718442,705242,OK
510.769673,delay,Tick,1639,1573,66,-66,142400,142800,17358,718442,705242,OK
511.03307,delay,Tick,1639,1573,66,-66,142400,142700,17358,718442,705242,OK
511.254063,delay,Tick,1639,1573,66,-66,142400,142700,17358,718442,705242,OK
511.528491,delay,Tick,1639,1573,66,-66,142400,142700,17358,718442,705242,OK
511.779084,delay,Tick,1639,1573,66,-66,142400,142700,17358,718442,705242,OK
511.977634,delay,Tick,1639,1573,66,-66,142400,142700,17358,718442,705242,OK
512.284211,delay,Tick,1639,1573,66,-66,142400,142700,17358,718442,705242,OK
512.491884,delay,Tick,1639,1573,66,-66,142400,142700,17358,718442,705242,OK
512.775998,delay,Tick,1639,1573,66,-66,142400,142500,17358,718442,711842,OK
512.985574,delay,Tick,1639,1573,66,-66,142400,142500,17358,718442,711842,OK
513.237075,delay,Tick,1639,1577,62,-62,142400,142400,17301,719299,719299,OK
513.527569,delay,Tick,1639,1577,62,-62,142400,142400,17301,719299,719299,OK
513.780327,delay,Tick,1639,1577,62,-62,142400,142400,17301,719299,719299,OK
514.024987,delay,Tick,1639,1577,62,-62,142400,142500,17301,719299,713099,OK
514.287488,delay,Tick,1639,1577,62,-62,142400,142500,17301,719299,713099,OK
514.518625,delay,Tick,1639,1577,62,-62,142400,142500,17301,719299,713099,OK
514.728003,delay,Tick,1639,1577,62,-62,142400,142500,17301,719299,713099,OK
515.040673,delay,Tick,1639,1577,62,-62,142400,142400,17301,719299,719299,OK
515.283227,delay,Tick,1639,1577,62,-62,142400,142400,17301,719299,719299,OK
515.509023,delay,Tick,1639,1577,62,-62,142400,142400,17301,719299,719299,OK
515.753973,delay,Tick,1639,1577,62,-62,142400,142400,17301,719299,719299,OK
516.020574,delay,Tick,1639,1577,62,-62,142400,142400,17301,719299,719299,OK
516.22437,delay,Tick,1639,1577,62,-62,142400,142400,17301,719299,719299,OK
516.501361,delay,Tick,1639,1577,62,-62,142400,142400,17301,719299,719299,OK
516.742456,delay,Tick,1639,1577,62,-62,142400,142400,17301,719299,719299,OK
517.032696,delay,Tick,1639,1577,62,-62,142400,142400,17301,719299,719299,OK
517.23835,delay,Tick,1639,1577,62,-62,142400,142400,17301,719299,719299,OK
517.477135,delay,Tick,1639,1577,62,-62,142400,142400,17301,719299,719299,OK
517.763486,delay,Tick,1639,1577,62,-62,142400,142400,17301,719299,719299,OK
517.957494,delay,Tick,1639,1577,62,-62,142400,142400,17301,719299,719299,OK
518.269944,delay,Tick,1639,1577,62,-62,142400,142400,17301,719299,719299,OK
518.542766,delay,Tick,1639,1577,62,-62,142400,142300,17301,719299,725499,OK
518.75969,delay,Tick,1639,1577,62,-62,142400,142300,17301,719299,725499,OK
519.030087,delay,Tick,1639,1577,62,-62,142400,142300,17301,719299,725499,OK
519.208562,delay,Tick,1639,1577,62,-62,142400,142300,17301,719299,725499,OK
519.540315,delay,Tick,1639,1577,62,-62,142400,142300,17301,719299,725499,OK
519.735498,delay,Tick,1639,1577,62,-62,142400,142300,17301,719299,725499,OK
520.019665,delay,Tick,1639,1577,62,-62,142400,142300,17301,719299,725499,OK
520.243221,delay,Tick,1639,1577,62,-62,142400,142300,17301,719299,725499,OK
520.534922,delay,Tick,1649,1587,62,-62,143000,142300,17442,723158,735558,OK
520.800481,delay,Tick,1649,1587,62,-62,143000,142500,17442,723158,735558,OK
521.049715,delay,Tick,1649,1597,52,-52,143000,142500,17299,725301,735701,OK
521.275828,delay,Tick,1649,1597,52,-52,143000,142500,17299,725301,735701,OK
521.49773,delay,Tick,1649,1597,52,-52,143000,142500,17299,725301,735701,OK
521.712224,delay,Tick,1649,1597,52,-52,143000,142500,17299,725301,735701,OK
521.999162,delay,Tick,1649,1597,52,-52,143000,142500,17299,725301,735701,OK
522.24666,delay,Tick,1649,1607,42,-42,142800,142200,17156,729444,737844,OK
522.516665,delay,Tick,1649,1607,42,-42,142800,142200,17156,729444,737844,OK
522.750757,delay,Tick,1649,1607,42,-42,142800,142200,17156,729444,737844,OK
522.952782,delay,Tick,1649,1607,42,-42,142800,142200,17156,729444,737844,OK
523.275926,delay,Tick,1649,1607,42,-42,142800,142500,17156,729444,737844,OK
523.478157,delay,Tick,1649,1607,42,-42,142800,142500,17156,729444,737844,OK
523.768948,delay,Tick,1649,1607,42,-42,142800,142400,17156,729444,737844,OK
524.019801,delay,Tick,1649,1607,42,-42,142800,142400,17156,729444,737844,OK
524.227789,delay,Tick,1649,1607,42,-42,142800,142400,17156,729444,737844,OK
524.458905,delay,Tick,1649,1607,42,-42,142800,142400,17156,729444,737844,OK
524.786384,delay,Tick,1649,1607,42,-42,142800,142400,17156,729444,737844,OK
525.015405,delay,Tick,1649,1607,42,-42,142800,142400,17156,729444,737844,OK
525.250766,delay,Tick,1649,1607,42,-42,142800,142400,17156,729444,737844,OK
525.501849,delay,Tick,1649,1607,42,-42,142800,142400,17156,729444,737844,OK
525.704822,delay,Tick,1659,1617,42,-42,142900,142400,16871,732729,741129,OK
526.005782,delay,Tick,1659,1617,42,-42,142900,142400,16871,732729,741129,OK
526.239061,delay,Tick,1659,1617,42,-42,142900,142400,16871,732729,741129,OK
526.47937,delay,Tick,1659,1617,42,-42,142900,142400,16871,732729,741129,OK
526.748631,delay,Tick,1659,1617,42,-42,142900,142400,16871,732729,741129,OK
526.994828,delay,Tick,1659,1617,42,-42,142900,142300,16871,732729,741129,OK
527.245413,delay,Tick,1659,1617,42,-42,142900,142300,16871,732729,741129,OK
527.495172,delay,Tick,1659,1617,42,-42,142900,142300,16871,732729,741129,OK
527.742668,delay,Tick,1659,1617,42,-42,142900,142300,16871,732729,741129,OK
528.015374,delay,Tick,1659,1617,42,-42,142100,142300,16871,732729,724329,OK
528.266859,delay,Tick,1659,1617,42,-42,142100,142300,16871,732729,724329,OK
528.545103,delay,Tick,1659,1627,32,-32,142900,142300,16728,735872,742272,OK
528.776391,delay,Tick,1659,1627,32,-32,142900,142300,16728,735872,742272,OK
528.985329,delay,Tick,1659,1627,32,-32,142900,142200,16728,735872,742272,OK
529.234429,delay,Tick,1659,1627,32,-32,142900,142200,16728,735872,742272,OK
529.495171,delay,Tick,1659,1627,32,-32,142900,142200,16728,735872,742272,OK
529.742117,delay,Tick,1659,1627,32,-32,142900,142000,16728,735872,742272,OK
529.972861,delay,Tick,1659,1627,32,-32,142900,142100,16728,735872,742272,OK
530.233351,delay,Tick,1659,1627,32,-32,142900,141900,16728,735872,742272,OK
530.476671,delay,Tick,1659,1637,22,-22,142100,141900,17012,736588,740988,OK
530.777234,delay,Tick,1659,1637,22,-22,142100,141900,17012,736588,740988,OK
530.97599,delay,Tick,1659,1637,22,-22,142100,141900,17012,736588,740988,OK
531.2554,delay,Tick,1659,1637,22,-22,142100,141900,17012,736588,740988,OK
531.545424,delay,Tick,1659,1647,12,-12,142600,141900,16870,738730,741130,OK
531.77565,delay,Tick,1659,1647,12,-12,142600,141900,16870,738730,741130,OK
532.036544,delay,Tick,1659,1647,12,-12,142600,141900,16870,738730,741130,OK
532.245911,delay,Tick,1659,1657,2,-2,142100,141900,17154,740446,740846,OK
532.503152,delay,Tick,1659,1667,-8,8,142100,141900,17438,742162,740562,OK
532.71362,delay,Tick,1659,1667,-8,8,142100,141900,17438,742162,740562,OK
533.016864,delay,Tick,1659,1667,-8,8,142100,141900,17438,742162,740562,OK
533.212226,delay,Tick,1659,1667,-8,8,142100,141900,17438,742162,740562,OK
533.466453,delay,Tick,1659,1667,-8,8,142100,142400,17438,742162,743762,OK
533.708977,delay,Tick,1659,1667,-8,8,142100,142500,17438,742162,743762,OK
534.02179,delay,Tick,1659,1667,-8,8,142100,142500,17438,742162,743762,OK
534.281433,delay,Tick,1659,1667,-8,8,142100,142200,17438,742162,742962,OK
534.482673,delay,Tick,1659,1667,-8,8,142100,142200,17438,742162,742962,OK
534.729086,delay,Tick,1659,1667,-8,8,142100,142200,17438,742162,742962,OK
535.050747,delay,Tick,1659,1667,-8,8,142100,142200,17438,742162,742962,OK
535.28797,delay,Tick,1659,1667,-8,8,142100,142000,17438,742162,741362,OK
535.542517,delay,Tick,1659,1667,-8,8,142100,142000,17438,742162,741362,OK
535.723029,delay,Tick,1659,1667,-8,8,142100,142000,17438,742162,741362,OK
536.046236,delay,Tick,1659,1667,-8,8,142200,142000,17438,742162,740562,OK
536.260679,delay,Tick,1659,1667,-8,8,142200,142000,17438,742162,740562,OK
536.467744,delay,Tick,1659,1667,-8,8,142200,142000,17438,742162,740562,OK
536.764844,delay,Tick,1659,1667,-8,8,142200,142000,17438,742162,740562,OK
536.961791,delay,Tick,1659,1667,-8,8,142200,142000,17438,742162,740562,OK
537.299946,delay,Tick,1659,1667,-8,8,142200,142000,17438,742162,740562,OK
537.536615,delay,Tick,1659,1667,-8,8,142200,142000,17438,742162,740562,OK
537.742763,delay,Tick,1659,1667,-8,8,142200,141900,17438,742162,740562,OK
537.982371,delay,Tick,1659,1667,-8,8,142200,141900,17438,742162,740562,OK
538.204395,delay,Tick,1659,1667,-8,8,142200,141900,17438,742162,740562,OK
538.524287,delay,Tick,1659,1667,-8,8,142200,141900,17438,742162,740562,OK
538.713647,delay,Tick,1659,1667,-8,8,142200,141900,17438,742162,740562,OK
538.986063,delay,Tick,1659,1667,-8,8,142200,141900,17438,742162,740562,OK
539.249518,delay,Tick,1659,1667,-8,8,142200,141900,17438,742162,740562,OK
539.549497,delay,Tick,1659,1677,-18,18,142100,141900,17722,743878,740278,OK
539.775081,delay,Tick,1659,1687,-28,28,142100,141600,18006,745594,739994,OK
540.048126,delay,Tick,1659,1697,-38,38,142100,141600,18290,748310,740710,OK
540.263192,delay,Tick,1659,1707,-48,48,142000,141600,18574,750026,740426,OK
540.525225,delay,Tick,1659,1707,-48,48,142000,141900,18574,750026,745226,OK
540.779875,delay,Tick,1659,1717,-58,58,142500,142000,18432,750168,738568,OK
541.044579,delay,Tick,1659,1717,-58,58,142500,142100,18432,750168,738568,OK
541.24236,delay,Tick,1659,1717,-58,58,142500,142100,18432,750168,738568,OK
541.489141,delay,Tick,1659,1717,-58,58,142500,142100,18432,750168,738568,OK
541.776629,delay,Tick,1659,1727,-68,68,142800,142100,18290,752310,738710,OK
541.962129,delay,Tick,1659,1727,-68,68,142000,142100,18290,752310,759110,OK
542.240777,delay,Tick,1659,1727,-68,68,141900,142000,18290,752310,759110,OK
542.482704,delay,Tick,1659,1727,-68,68,141900,142000,18290,752310,759110,OK
542.778638,delay,Tick,1659,1727,-68,68,141900,142000,18290,752310,759110,OK
542.968187,delay,Tick,1659,1727,-68,68,141900,142000,18290,752310,759110,OK
543.220948,delay,Tick,1659,1727,-68,68,141900,142000,18290,752310,759110,OK
543.530694,delay,Tick,1659,1727,-68,68,141900,142000,18290,752310,759110,OK
543.797288,delay,Tick,1659,1727,-68,68,141900,141900,18290,752310,752310,OK
544.055096,delay,Tick,1659,1727,-68,68,141900,141900,18290,752310,752310,OK
544.295197,delay,Tick,1659,1727,-68,68,141900,142000,18290,752310,759110,OK
544.485445,delay,Tick,1659,1727,-68,68,141900,142000,18290,752310,759110,OK
544.714111,delay,Tick,1659,1727,-68,68,141900,141900,18290,752310,752310,OK
544.976893,delay,Tick,1659,1727,-68,68,141900,141900,18290,752310,752310,OK
545.268541,delay,Tick,1659,1727,-68,68,141900,141900,18290,752310,752310,OK
545.53299,delay,Tick,1659,1727,-68,68,141900,141700,18290,752310,738710,OK
545.765917,delay,Tick,1659,1727,-68,68,141900,141700,18290,752310,738710,OK
545.990396,delay,Tick,1659,1727,-68,68,141900,141800,18290,752310,745510,OK
546.298607,delay,Tick,1659,1730,-71,71,141900,141800,18247,752653,745553,OK
546.547725,delay,Tick,1659,1730,-71,71,141900,141800,18247,752653,745553,OK
546.766906,delay,Tick,1659,1730,-71,71,141900,141800,18247,752653,745553,OK
546.958943,delay,Tick,1659,1730,-71,71,141900,141800,18247,752653,745553,OK
547.215271,delay,Tick,1659,1730,-71,71,141900,141800,18247,752653,745553,OK
547.479323,delay,Tick,1659,1730,-71,71,141900,141800,18247,752653,745553,OK
547.744317,delay,Tick,1659,1730,-71,71,141900,141800,18247,752653,745553,OK
547.998548,delay,Tick,1659,1730,-71,71,141900,141800,18247,752653,745553,OK
548.286413,delay,Tick,1659,1730,-71,71,141900,142000,18247,752653,759753,OK
548.496965,delay,Tick,1659,1730,-71,71,141900,142000,18247,752653,759753,OK
548.736605,delay,Tick,1659,1739,-80,80,142300,142000,18119,754581,738581,OK
549.047623,delay,Tick,1659,1739,-80,80,141900,142000,18119,754581,762581,OK
549.222312,delay,Tick,1659,1739,-80,80,141900,142000,18119,754581,762581,OK
549.477309,delay,Tick,1659,1739,-80,80,141900,141800,18119,754581,746581,OK
549.794359,delay,Tick,1659,1739,-80,80,141900,141800,18119,754581,746581,OK
550.023765,delay,Tick,1659,1739,-80,80,141900,141800,18119,754581,746581,OK
550.263982,delay,Tick,1659,1739,-80,80,141900,141800,18119,754581,746581,OK
550.477734,delay,Tick,1659,1739,-80,80,141900,141800,18119,754581,746581,OK
550.740852,delay,Tick,1659,1739,-80,80,141900,141800,18119,754581,746581,OK
551.048833,delay,Tick,1659,1739,-80,80,141900,141800,18119,754581,746581,OK
551.285496,delay,Tick,1659,1739,-80,80,141900,141800,18119,754581,746581,OK
551.453311,delay,Tick,1659,1739,-80,80,141900,141800,18119,754581,746581,OK
551.705732,delay,Tick,1659,1739,-80,80,141900,141800,18119,754581,746581,OK
552.029482,delay,Tick,1659,1739,-80,80,141900,141800,18119,754581,746581,OK
552.264336,delay,Tick,1659,1749,-90,90,142400,141700,17977,756723,738723,OK
552.51775,delay,Tick,1659,1749,-90,90,142400,141700,17977,756723,738723,OK
552.736441,delay,Tick,1659,1749,-90,90,142400,141700,17977,756723,738723,OK
552.999136,delay,Tick,1659,1749,-90,90,142400,141700,17977,756723,738723,OK
553.23373,delay,Tick,1659,1749,-90,90,142400,141700,17977,756723,738723,OK
553.464623,delay,Tick,1659,1749,-90,90,142200,141700,17977,756723,738723,OK
553.782432,delay,Tick,1659,1749,-90,90,141900,141600,17977,756723,738723,OK
554.008894,delay,Tick,1659,1749,-90,90,141900,141600,17977,756723,738723,OK
554.274661,delay,Tick,1659,1749,-90,90,141900,141600,17977,756723,738723,OK
554.462004,delay,Tick,1659,1749,-90,90,141900,141600,17977,756723,738723,OK
554.793707,delay,Tick,1659,1749,-90,90,141900,141500,17977,756723,738723,OK
555.029899,delay,Tick,1659,1749,-90,90,141900,141500,17977,756723,738723,OK
555.218335,delay,Tick,1659,1749,-90,90,141900,141500,17977,756723,738723,OK
555.472256,delay,Tick,1659,1749,-90,90,141900,141500,17977,756723,738723,OK
555.759211,delay,Tick,1659,1749,-90,90,142000,141500,17977,756723,738723,OK
556.040784,delay,Tick,1659,1749,-90,90,142000,141200,17977,756723,738723,OK
556.286693,delay,Tick,1659,1749,-90,90,141800,141100,17977,756723,738723,OK
556.467338,delay,Tick,1659,1749,-90,90,141600,141100,17977,756723,738723,OK
556.77698,delay,Tick,1659,1749,-90,90,141600,141000,17977,756723,738723,OK
557.036909,delay,Tick,1659,1749,-90,90,141500,141000,17977,756723,738723,OK
557.231452,delay,Tick,1659,1749,-90,90,141500,141000,17977,756723,738723,OK
557.487034,delay,Tick,1659,1749,-90,90,141500,141000,17977,756723,738723,OK
557.746488,delay,Tick,1659,1749,-90,90,141500,140900,17977,756723,738723,OK
558.011802,delay,Tick,1659,1749,-90,90,141500,141100,17977,756723,738723,OK
558.236582,delay,Tick,1659,1749,-90,90,141500,141100,17977,756723,738723,OK
558.533854,delay,Tick,1659,1749,-90,90,141500,141100,17977,756723,738723,OK
558.75763,delay,Tick,1659,1749,-90,90,141500,141100,17977,756723,738723,OK
558.999826,delay,Tick,1659,1749,-90,90,141500,141100,17977,756723,738723,OK
559.294944,delay,Tick,1659,1749,-90,90,141500,141100,17977,756723,738723,OK
559.46855,delay,Tick,1659,1749,-90,90,141500,141100,17977,756723,738723,OK
559.800073,delay,Tick,1659,1749,-90,90,141500,141100,17977,756723,738723,OK
560.045279,delay,Tick,1659,1749,-90,90,141500,141100,17977,756723,738723,OK
560.286629,delay,Tick,1659,1749,-90,90,141500,141300,17977,756723,738723,OK
560.495271,delay,Tick,1659,1749,-90,90,141500,141300,17977,756723,738723,OK
560.737638,delay,Tick,1659,1749,-90,90,141500,141300,17977,756723,738723,OK
560.965725,delay,Tick,1659,1749,-90,90,141500,141300,17977,756723,738723,OK
561.248407,delay,Tick,1659,1749,-90,90,141500,141300,17977,756723,738723,OK
561.474082,delay,Tick,1659,1749,-90,90,141500,141300,17977,756723,738723,OK
561.712683,delay,Tick,1659,1749,-90,90,141500,141300,17977,756723,738723,OK
561.957321,delay,Tick,1659,1749,-90,90,141500,141300,17977,756723,738723,OK
562.221987,delay,Tick,1659,1749,-90,90,142000,141300,17977,756723,738723,OK
562.456817,delay,Tick,1659,1749,-90,90,141500,141300,17977,756723,738723,OK
562.793512,delay,Tick,1659,1749,-90,90,141500,141000,17977,756723,738723,OK
562.970786,delay,Tick,1659,1749,-90,90,141500,141000,17977,756723,738723,OK
563.243909,delay,Tick,1659,1749,-90,90,141600,141000,17977,756723,738723,OK
563.491393,delay,Tick,1659,1749,-90,90,141600,141000,17977,756723,738723,OK
563.727785,delay,Tick,1659,1749,-90,90,141600,141000,17977,756723,738723,OK
563.969396,delay,Tick,1659,1749,-90,90,141600,141000,17977,756723,738723,OK
564.272831,delay,Tick,1659,1749,-90,90,141600,141000,17977,756723,738723,OK
564.492669,delay,Tick,1659,1749,-90,90,141600,141000,17977,756723,738723,OK
564.759398,delay,Tick,1659,1749,-90,90,141300,140800,17977,756723,738723,OK
564.969646,delay,Tick,1659,1749,-90,90,141300,140800,17977,756723,738723,OK
565.243178,delay,Tick,1659,1749,-90,90,141300,140800,17977,756723,738723,OK
565.535736,delay,Tick,1659,1749,-90,90,141300,140800,17977,756723,738723,OK
565.774015,delay,Tick,1659,1749,-90,90,141300,140800,17977,756723,738723,OK
565.982577,delay,Tick,1659,1749,-90,90,141400,140800,17977,756723,738723,OK
566.274774,delay,Tick,1659,1749,-90,90,141400,140800,17977,756723,738723,OK
566.470948,delay,Tick,1659,1749,-90,90,141400,140900,17977,756723,738723,OK
566.742231,delay,Tick,1659,1749,-90,90,141400,140900,17977,756723,738723,OK
567.017635,delay,Tick,1659,1749,-90,90,141600,140900,17977,756723,738723,OK
567.280608,delay,Tick,1659,1749,-90,90,141300,141000,17977,756723,738723,OK
567.498342,delay,Tick,1659,1749,-90,90,141300,141000,17977,756723,738723,OK
567.729065,delay,Tick,1659,1749,-90,90,141300,141000,17977,756723,738723,OK
568.000943,delay,Tick,1659,1749,-90,90,141300,141000,17977,756723,738723,OK
568.293023,delay,Tick,1659,1749,-90,90,141300,141000,17977,756723,738723,OK
568.490945,delay,Tick,1659,1749,-90,90,141300,141000,17977,756723,738723,OK
568.779061,delay,Tick,1659,1749,-90,90,141300,141000,17977,756723,738723,OK
569.003935,delay,Tick,1659,1749,-90,90,141300,141000,17977,756723,738723,OK
569.204401,delay,Tick,1659,1749,-90,90,141300,141000,17977,756723,738723,OK
569.491593,delay,Tick,1659,1749,-90,90,141200,141000,17977,756723,738723,OK
569.775099,delay,Tick,1659,1749,-90,90,141200,141000,17977,756723,738723,OK
569.96381,delay,Tick,1659,1749,-90,90,141200,141000,17977,756723,738723,OK
570.255027,delay,Tick,1659,1749,-90,90,141200,141000,17977,756723,738723,OK
570.533285,delay,Tick,1659,1749,-90,90,141200,141000,17977,756723,738723,OK
570.761912,delay,Tick,1659,1749,-90,90,141200,141000,17977,756723,738723,OK
570.963117,delay,Tick,1659,1749,-90,90,141200,141000,17977,756723,738723,OK
571.240032,delay,Tick,1659,1749,-90,90,141200,141000,17977,756723,738723,OK
571.519486,delay,Tick,1659,1749,-90,90,141200,141000,17977,756723,738723,OK
571.760611,delay,Tick,1659,1749,-90,90,141200,141000,17977,756723,738723,OK
572.009552,delay,Tick,1659,1749,-90,90,141200,141000,17977,756723,738723,OK
572.211586,delay,Tick,1659,1749,-90,90,141200,141000,17977,756723,738723,OK
572.456337,delay,Tick,1659,1749,-90,90,141200,141000,17977,756723,738723,OK
572.77446,delay,Tick,1659,1749,-90,90,141100,141000,17977,756723,747723,OK
573.040445,delay,Tick,1659,1749,-90,90,141100,140900,17977,756723,738723,OK
573.299397,delay,Tick,1659,1749,-90,90,141100,140900,17977,756723,738723,OK
573.545658,delay,Tick,1659,1749,-90,90,141100,140800,17977,756723,738723,OK
573.700688,delay,Tick,1659,1749,-90,90,141100,140400,17977,756723,738723,OK
573.994146,delay,Tick,1659,1749,-90,90,141100,140400,17977,756723,738723,OK
574.215111,delay,Tick,1659,1749,-90,90,141100,140400,17977,756723,738723,OK
574.486283,delay,Tick,1659,1749,-90,90,141100,140400,17977,756723,738723,OK
574.770531,delay,Tick,1659,1749,-90,90,141100,140400,17977,756723,738723,OK
574.974294,delay,Tick,1659,1749,-90,90,141000,140400,17977,756723,738723,OK
575.284663,delay,Tick,1659,1749,-90,90,141000,140400,17977,756723,738723,OK
575.493879,delay,Tick,1659,1749,-90,90,141000,140400,17977,756723,738723,OK
575.795965,delay,Tick,1659,1749,-90,90,141000,140400,17977,756723,738723,OK
575.955747,delay,Tick,1659,1749,-90,90,141000,140400,17977,756723,738723,OK
576.292019,delay,Tick,1659,1749,-90,90,141000,140400,17977,756723,738723,OK
576.549823,delay,Tick,1659,1749,-90,90,141000,140400,17977,756723,738723,OK
576.736031,delay,Tick,1659,1749,-90,90,141000,140400,17977,756723,738723,OK
576.970682,delay,Tick,1659,1749,-90,90,141000,140400,17977,756723,738723,OK
577.271146,delay,Tick,1659,1749,-90,90,141100,140400,17977,756723,738723,OK
577.507263,delay,Tick,1659,1749,-90,90,141100,140400,17977,756723,738723,OK
577.761783,delay,Tick,1659,1749,-90,90,141000,140400,17977,756723,738723,OK
577.981342,delay,Tick,1659,1749,-90,90,141000,140400,17977,756723,738723,OK
578.268563,delay,Tick,1659,1749,-90,90,140900,140400,17977,756723,738723,OK
578.546798,delay,Tick,1659,1749,-90,90,140800,140400,17977,756723,738723,OK
578.723231,delay,Tick,1659,1749,-90,90,141000,140400,17977,756723,738723,OK
578.98464,delay,Tick,1659,1749,-90,90,141000,140400,17977,756723,738723,OK
579.2701,delay,Tick,1659,1749,-90,90,141000,140400,17977,756723,738723,OK
579.506062,delay,Tick,1659,1749,-90,90,141000,140400,17977,756723,738723,OK
579.71437,delay,Tick,1659,1749,-90,90,141000,140400,17977,756723,738723,OK
579.987738,delay,Tick,1659,1749,-90,90,141000,140400,17977,756723,738723,OK
580.254894,delay,Tick,1659,1749,-90,90,141000,140400,17977,756723,738723,OK
580.548964,delay,Tick,1659,1749,-90,90,141000,140400,17977,756723,738723,OK
580.747758,delay,Tick,1659,1749,-90,90,141000,140400,17977,756723,738723,OK
580.999985,delay,Tick,1659,1749,-90,90,141000,140400,17977,756723,738723,OK
581.296858,delay,Tick,1659,1749,-90,90,141100,140400,17977,756723,738723,OK
581.532295,delay,Tick,1659,1749,-90,90,141100,140400,17977,756723,738723,OK
581.799915,delay,Tick,1659,1749,-90,90,141100,140400,17977,756723,738723,OK
581.967242,delay,Tick,1659,1749,-90,90,141100,140400,17977,756723,738723,OK
582.205385,delay,Tick,1659,1749,-90,90,141100,140700,17977,756723,738723,OK
582.483615,delay,Tick,1659,1749,-90,90,141100,140700,17977,756723,738723,OK
582.737595,delay,Tick,1659,1749,-90,90,141100,140700,17977,756723,738723,OK
582.987242,delay,Tick,1659,1749,-90,90,141100,140700,17977,756723,738723,OK
583.286572,delay,Tick,1659,1749,-90,90,141100,140700,17977,756723,738723,OK
583.494542,delay,Tick,1659,1749,-90,90,141100,140700,17977,756723,738723,OK
583.778573,delay,Tick,1659,1749,-90,90,141100,140700,17977,756723,738723,OK
584.033617,delay,Tick,1659,1749,-90,90,141100,140700,17977,756723,738723,OK
584.202678,delay,Tick,1659,1749,-90,90,141100,140700,17977,756723,738723,OK
584.475602,delay,Tick,1659,1749,-90,90,141200,140700,17977,756723,738723,OK
584.784749,delay,Tick,1659,1749,-90,90,141200,140700,17977,756723,738723,OK
584.988262,delay,Tick,1659,1749,-90,90,141200,140700,17977,756723,738723,OK
585.287904,delay,Tick,1659,1749,-90,90,141200,140700,17977,756723,738723,OK
585.492266,delay,Tick,1659,1749,-90,90,141200,140700,17977,756723,738723,OK
585.767855,delay,Tick,1659,1749,-90,90,141200,140700,17977,756723,738723,OK
585.996923,delay,Tick,1659,1749,-90,90,141200,140700,17977,756723,738723,OK
586.221595,delay,Tick,1659,1749,-90,90,141000,140700,17977,756723,738723,OK
586.477523,delay,Tick,1659,1749,-90,90,141000,140400,17977,756723,738723,OK
586.720067,delay,Tick,1659,1749,-90,90,141000,140400,17977,756723,738723,OK
586.979037,delay,Tick,1659,1749,-90,90,140800,140400,17977,756723,738723,OK
587.210687,delay,Tick,1659,1749,-90,90,140600,140400,17977,756723,738723,OK
587.543495,delay,Tick,1659,1749,-90,90,140600,140400,17977,756723,738723,OK
587.758262,delay,Tick,1659,1749,-90,90,140600,140400,17977,756723,738723,OK
587.988823,delay,Tick,1659,1749,-90,90,140800,140400,17977,756723,738723,OK
588.292665,delay,Tick,1659,1749,-90,90,140800,140400,17977,756723,738723,OK
588.504682,delay,Tick,1659,1749,-90,90,140600,140200,17977,756723,738723,OK
588.72959,delay,Tick,1659,1749,-90,90,140600,140200,17977,756723,738723,OK
588.997507,delay,Tick,1659,1749,-90,90,140600,140200,17977,756723,738723,OK
589.244979,delay,Tick,1659,1749,-90,90,140800,140300,17977,756723,738723,OK
589.465931,delay,Tick,1659,1749,-90,90,140800,140300,17977,756723,738723,OK
589.71661,delay,Tick,1659,1749,-90,90,140800,140300,17977,756723,738723,OK
590.002866,delay,Tick,1659,1749,-90,90,141000,140300,17977,756723,738723,OK
590.20389,delay,Tick,1659,1749,-90,90,141000,140300,17977,756723,738723,OK
590.497376,delay,Tick,1659,1749,-90,90,141000,140300,17977,756723,738723,OK
590.718867,delay,Tick,1659,1749,-90,90,141000,140300,17977,756723,738723,OK
590.996827,delay,Tick,1659,1749,-90,90,140600,140300,17977,756723,738723,OK
591.23869,delay,Tick,1659,1749,-90,90,140600,140300,17977,756723,738723,OK
591.534265,delay,Tick,1659,1749,-90,90,140600,140300,17977,756723,738723,OK
591.787465,delay,Tick,1659,1749,-90,90,140600,140300,17977,756723,738723,OK
591.989657,delay,Tick,1659,1749,-90,90,140600,140300,17977,756723,738723,OK
592.28691,delay,Tick,1659,1749,-90,90,140600,140300,17977,756723,738723,OK
592.467511,delay,Tick,1659,1749,-90,90,140600,140300,17977,756723,738723,OK
592.726461,delay,Tick,1659,1749,-90,90,140600,140300,17977,756723,738723,OK
592.984158,delay,Tick,1659,1749,-90,90,140600,140300,17977,756723,738723,OK
593.217249,delay,Tick,1659,1749,-90,90,140600,140300,17977,756723,738723,OK
593.480328,delay,Tick,1659,1749,-90,90,140600,140300,17977,756723,738723,OK
593.732036,delay,Tick,1659,1749,-90,90,140600,140300,17977,756723,738723,OK
593.980985,delay,Tick,1659,1749,-90,90,141000,140300,17977,756723,738723,OK
594.283402,delay,Tick,1659,1749,-90,90,140600,140300,17977,756723,738723,OK
594.509924,delay,Tick,1659,1749,-90,90,140600,140300,17977,756723,738723,OK
594.789772,delay,Tick,1659,1749,-90,90,140600,140300,17977,756723,738723,OK
595.037505,delay,Tick,1659,1749,-90,90,140600,140300,17977,756723,738723,OK
595.232738,delay,Tick,1659,1749,-90,90,140600,140300,17977,756723,738723,OK
595.52685,delay,Tick,1659,1749,-90,90,140600,140500,17977,756723,747723,OK
595.707403,delay,Tick,1659,1749,-90,90,140600,140500,17977,756723,747723,OK
596.002202,delay,Tick,1659,1749,-90,90,140600,140500,17977,756723,747723,OK
596.212425,delay,Tick,1659,1749,-90,90,140600,140500,17977,756723,747723,OK
596.533961,delay,Tick,1659,1749,-90,90,141000,140500,17977,756723,738723,OK
596.771885,delay,Tick,1659,1749,-90,90,141000,140300,17977,756723,738723,OK
596.952318,delay,Tick,1659,1749,-90,90,141000,140300,17977,756723,738723,OK
597.291967,delay,Tick,1659,1749,-90,90,141000,140300,17977,756723,738723,OK
597.53791,delay,Tick,1659,1749,-90,90,141000,140300,17977,756723,738723,OK
597.703902,delay,Tick,1659,1749,-90,90,141000,140300,17977,756723,738723,OK
598.040464,delay,Tick,1659,1749,-90,90,141000,140300,17977,756723,738723,OK
598.219825,delay,Tick,1659,1749,-90,90,141000,140300,17977,756723,738723,OK
598.50115,delay,Tick,1659,1749,-90,90,141000,140300,17977,756723,738723,OK
598.757509,delay,Tick,1659,1749,-90,90,140800,140300,17977,756723,738723,OK
598.95403,delay,Tick,1659,1749,-90,90,140800,140300,17977,756723,738723,OK
599.232999,delay,Tick,1659,1749,-90,90,140600,140300,17977,756723,738723,OK
599.51043,delay,Tick,1659,1749,-90,90,140600,140300,17977,756723,738723,OK
599.741042,delay,Tick,1659,1749,-90,90,140600,140300,17977,756723,738723,OK
600.02438,delay,Tick,1659,1749,-90,90,140600,140300,17977,756723,738723,OK
600.265958,delay,Tick,1659,1749,-90,90,140600,140200,17977,756723,738723,OK
600.528622,delay,Tick,1659,1749,-90,90,140600,140200,17977,756723,738723,OK
600.707295,delay,Tick,1659,1749,-90,90,140600,140200,17977,756723,738723,OK
601.042241,delay,Tick,1659,1749,-90,90,140600,139800,17977,756723,738723,OK
601.223634,delay,Tick,1659,1749,-90,90,140400,139800,17977,756723,738723,OK
601.49575,delay,Tick,1659,1749,-90,90,140200,139800,17977,756723,738723,OK
601.760314,delay,Tick,1659,1749,-90,90,140200,139800,17977,756723,738723,OK
602.038066,delay,Tick,1659,1749,-90,90,140200,139800,17977,756723,738723,OK
602.217398,delay,Tick,1659,1749,-90,90,140200,139800,17977,756723,738723,OK
602.528731,delay,Tick,1659,1749,-90,90,140200,139800,17977,756723,738723,OK
602.70191,delay,Tick,1659,1749,-90,90,140200,139800,17977,756723,738723,OK
603.022157,delay,Tick,1659,1749,-90,90,140200,139800,17977,756723,738723,OK
603.282015,delay,Tick,1659,1749,-90,90,140200,139700,17977,756723,738723,OK
603.511605,delay,Tick,1659,1749,-90,90,140200,139700,17977,756723,738723,OK
603.753675,delay,Tick,1659,1749,-90,90,140200,139700,17977,756723,738723,OK
604.001929,delay,Tick,1659,1749,-90,90,140200,139700,17977,756723,738723,OK
604.237359,delay,Tick,1659,1749,-90,90,140000,139700,17977,756723,738723,OK
604.47595,delay,Tick,1659,1749,-90,90,140400,139800,17977,756723,738723,OK
604.710162,delay,Tick,1659,1749,-90,90,140400,139700,17977,756723,738723,OK
605.025149,delay,Tick,1659,1749,-90,90,140400,139700,17977,756723,738723,OK
605.277714,delay,Tick,1659,1749,-90,90,140400,139600,17977,756723,738723,OK
605.532537,delay,Tick,1659,1749,-90,90,140400,139600,17977,756723,738723,OK
605.770688,delay,Tick,1659,1749,-90,90,140400,139600,17977,756723,738723,OK
606.022945,delay,Tick,1659,1749,-90,90,140200,139600,17977,756723,738723,OK
606.246416,delay,Tick,1659,1749,-90,90,140100,139600,17977,756723,738723,OK
606.524195,delay,Tick,1659,1749,-90,90,140000,139600,17977,756723,738723,OK
606.740938,delay,Tick,1659,1749,-90,90,140000,139600,17977,756723,738723,OK
606.976367,delay,Tick,1659,1749,-90,90,140000,139600,17977,756723,738723,OK
607.251811,delay,Tick,1659,1749,-90,90,140400,139600,17977,756723,738723,OK
607.474563,delay,Tick,1659,1749,-90,90,140400,139600,17977,756723,738723,OK
607.725912,delay,Tick,1659,1749,-90,90,140400,139600,17977,756723,738723,OK
608.018389,delay,Tick,1659,1749,-90,90,140400,139600,17977,756723,738723,OK
608.286522,delay,Tick,1659,1749,-90,90,140400,139600,17977,756723,738723,OK
608.522493,delay,Tick,1659,1749,-90,90,140400,139600,17977,756723,738723,OK
608.747829,delay,Tick,1659,1749,-90,90,140400,139600,17977,756723,738723,OK
608.96952,delay,Tick,1659,1749,-90,90,140200,139600,17977,756723,738723,OK
609.204364,delay,Tick,1659,1749,-90,90,140200,139600,17977,756723,738723,OK
609.490085,delay,Tick,1659,1749,-90,90,140200,139600,17977,756723,738723,OK
609.730875,delay,Tick,1659,1749,-90,90,140200,139600,17977,756723,738723,OK
609.952846,delay,Tick,1659,1749,-90,90,140200,139600,17977,756723,738723,OK
610.201561,delay,Tick,1659,1749,-90,90,140200,139800,17977,756723,738723,OK
610.528955,delay,Tick,1659,1749,-90,90,140200,139800,17977,756723,738723,OK
610.772167,delay,Tick,1659,1749,-90,90,140200,139800,17977,756723,738723,OK
610.959471,delay,Tick,1659,1749,-90,90,140200,139800,17977,756723,738723,OK
611.27778,delay,Tick,1659,1749,-90,90,140200,139800,17977,756723,738723,OK
611.540992,delay,Tick,1659,1749,-90,90,140200,139800,17977,756723,738723,OK
611.72787,delay,Tick,1659,1749,-90,90,140200,139800,17977,756723,738723,OK
611.997238,delay,Tick,1659,1749,-90,90,140200,139800,17977,756723,738723,OK
612.259758,delay,Tick,1659,1749,-90,90,140200,139800,17977,756723,738723,OK
612.542316,delay,Tick,1659,1749,-90,90,140200,139800,17977,756723,738723,OK
612.795621,delay,Tick,1659,1749,-90,90,140200,139900,17977,756723,738723,OK
613.044003,delay,Tick,1659,1749,-90,90,140200,139800,17977,756723,738723,OK
613.248364,delay,Tick,1659,1749,-90,90,140200,139800,17977,756723,738723,OK
613.478376,delay,Tick,1659,1749,-90,90,140200,139800,17977,756723,738723,OK
613.772248,delay,Tick,1659,1749,-90,90,140200,139600,17977,756723,738723,OK
613.985696,delay,Tick,1659,1749,-90,90,140200,139600,17977,756723,738723,OK
614.273318,delay,Tick,1659,1749,-90,90,140200,139600,17977,756723,738723,OK
614.51176,delay,Tick,1659,1749,-90,90,140200,139600,17977,756723,738723,OK
614.785939,delay,Tick,1659,1749,-90,90,140200,139600,17977,756723,738723,OK
614.97909,delay,Tick,1659,1749,-90,90,140200,139600,17977,756723,738723,OK
615.283172,delay,Tick,1659,1749,-90,90,140200,139600,17977,756723,738723,OK
615.523691,delay,Tick,1659,1749,-90,90,140200,139600,17977,756723,738723,OK
615.782304,delay,Tick,1659,1749,-90,90,140000,139600,17977,756723,738723,OK
616.01823,delay,Tick,1659,1749,-90,90,140000,139600,17977,756723,738723,OK
616.293165,delay,Tick,1659,1749,-90,90,140000,139600,17977,756723,738723,OK
616.489864,delay,Tick,1659,1749,-90,90,140000,139600,17977,756723,738723,OK
616.754025,delay,Tick,1659,1749,-90,90,140000,139600,17977,756723,738723,OK
617.045868,delay,Tick,1659,1749,-90,90,140000,139600,17977,756723,738723,OK
617.242481,delay,Tick,1659,1749,-90,90,140000,139600,17977,756723,738723,OK
617.506748,delay,Tick,1659,1749,-90,90,140000,139600,17977,756723,738723,OK
617.720735,delay,Tick,1659,1749,-90,90,140000,139600,17977,756723,738723,OK
618.032175,delay,Tick,1659,1749,-90,90,140000,139600,17977,756723,738723,OK
618.21934,delay,Tick,1659,1749,-90,90,139900,139600,17977,756723,738723,OK
618.464732,delay,Tick,1659,1749,-90,90,140200,139600,17977,756723,738723,OK
618.751676,delay,Tick,1659,1749,-90,90,140200,139700,17977,756723,738723,OK
618.988204,delay,Tick,1659,1749,-90,90,140200,139700,17977,756723,738723,OK
619.247992,delay,Tick,1659,1749,-90,90,140200,139700,17977,756723,738723,OK
619.459925,delay,Tick,1659,1749,-90,90,140200,139700,17977,756723,738723,OK
619.796832,delay,Tick,1659,1749,-90,90,140200,139700,17977,756723,738723,OK
620.037165,delay,Tick,1659,1749,-90,90,140200,140000,17977,756723,738723,OK
620.232909,delay,Tick,1659,1749,-90,90,140200,139900,17977,756723,738723,OK
620.510179,delay,Tick,1659,1749,-90,90,140200,139900,17977,756723,738723,OK
620.739927,delay,Tick,1659,1749,-90,90,140200,139900,17977,756723,738723,OK
621.013452,delay,Tick,1659,1749,-90,90,140200,139900,17977,756723,738723,OK
621.284329,delay,Tick,1659,1749,-90,90,140200,139900,17977,756723,738723,OK
621.541153,delay,Tick,1659,1749,-90,90,140200,139900,17977,756723,738723,OK
621.790167,delay,Tick,1659,1749,-90,90,140200,139900,17977,756723,738723,OK
622.030213,delay,Tick,1659,1749,-90,90,139900,139900,17977,756723,756723,OK
622.275445,delay,Tick,1659,1749,-90,90,139900,139900,17977,756723,756723,OK
622.48229,delay,Tick,1659,1749,-90,90,139900,139900,17977,756723,756723,OK
622.707904,delay,Tick,1659,1749,-90,90,140200,139900,17977,756723,738723,OK
622.997372,delay,Tick,1659,1749,-90,90,140200,139900,17977,756723,738723,OK
623.224963,delay,Tick,1659,1749,-90,90,140200,139900,17977,756723,738723,OK
623.482555,delay,Tick,1659,1749,-90,90,140500,139900,17977,756723,738723,OK
623.701282,delay,Tick,1659,1749,-90,90,140500,140100,17977,756723,738723,OK
623.993562,delay,Tick,1659,1749,-90,90,140500,140100,17977,756723,738723,OK
624.285909,delay,Tick,1659,1749,-90,90,140500,140100,17977,756723,738723,OK
624.474179,delay,Tick,1659,1749,-90,90,139900,140100,17977,756723,774723,OK
624.747754,delay,Tick,1659,1749,-90,90,139900,140300,17977,756723,774723,OK
625.005763,delay,Tick,1659,1749,-90,90,139900,140300,17977,756723,774723,OK
625.221285,delay,Tick,1659,1749,-90,90,139900,140300,17977,756723,774723,OK
625.477964,delay,Tick,1659,1749,-90,90,141000,140300,17977,756723,738723,OK
625.767032,delay,Tick,1659,1749,-90,90,141000,140300,17977,756723,738723,OK
625.969196,delay,Tick,1659,1749,-90,90,141000,140300,17977,756723,738723,OK
626.23079,delay,Tick,1659,1749,-90,90,141000,140300,17977,756723,738723,OK
626.516532,delay,Tick,1678,1749,-71,71,140200,140300,17711,760789,767889,OK
626.772416,delay,Tick,1690,1749,-59,59,140200,140300,17543,763357,769257,OK
626.965232,delay,Tick,1690,1749,-59,59,140200,140600,17543,763357,775157,OK
627.267001,delay,Tick,1690,1749,-59,59,140200,140600,17543,763357,775157,OK
627.513367,delay,Tick,1690,1749,-59,59,140200,140600,17543,763357,775157,OK
627.752849,delay,Tick,1690,1749,-59,59,140200,140600,17543,763357,775157,OK
628.008178,delay,Tick,1700,1749,-49,49,139900,140600,17403,765497,775297,OK
628.245807,delay,Tick,1710,1749,-39,39,140000,140600,17263,768637,776437,OK
628.508455,delay,Tick,1720,1749,-29,29,139700,140600,17543,771357,777157,OK
628.774596,delay,Tick,1730,1749,-19,19,140000,140600,17823,773077,776877,OK
629.032701,delay,Tick,1740,1749,-9,9,140000,140600,18103,774797,776597,OK
629.276422,delay,Tick,1740,1759,-19,19,140500,140600,17963,776937,778837,OK
629.47355,delay,Tick,1740,1759,-19,19,140500,140600,17963,776937,778837,OK
629.753727,delay,Tick,1740,1759,-19,19,140500,140600,17963,776937,778837,OK
629.961834,delay,Tick,1740,1759,-19,19,140500,140600,17963,776937,778837,OK
630.21036,delay,Tick,1740,1759,-19,19,140500,140600,17963,776937,778837,OK
630.480759,delay,Tick,1740,1759,-19,19,140500,140600,17963,776937,778837,OK
630.726137,delay,Tick,1740,1759,-19,19,140500,140600,17963,776937,778837,OK
630.982776,delay,Tick,1740,1759,-19,19,140500,140600,17963,776937,778837,OK
631.210226,delay,Tick,1740,1759,-19,19,140500,140600,17963,776937,778837,OK
631.499106,delay,Tick,1740,1759,-19,19,140500,140600,17963,776937,778837,OK
631.732083,delay,Tick,1740,1759,-19,19,140500,140600,17963,776937,778837,OK
631.967065,delay,Tick,1740,1759,-19,19,140500,140600,17963,776937,778837,OK
632.215582,delay,Tick,1740,1759,-19,19,140500,140500,17963,776937,776937,OK
632.453102,delay,Tick,1740,1759,-19,19,140500,140500,17963,776937,776937,OK
632.731907,delay,Tick,1740,1759,-19,19,140500,140500,17963,776937,776937,OK
632.970604,delay,Tick,1740,1759,-19,19,140700,140500,17963,776937,773137,OK
633.246159,delay,Tick,1740,1759,-19,19,140700,140500,17963,776937,773137,OK
633.542501,delay,Tick,1740,1759,-19,19,140700,140500,17963,776937,773137,OK
633.709896,delay,Tick,1740,1769,-29,29,140700,140500,18244,778656,772856,OK
633.967281,delay,Tick,1740,1779,-39,39,140700,140500,18525,782375,774575,OK
634.257887,delay,Tick,1740,1789,-49,49,140700,140000,18806,784094,774294,OK
634.509233,delay,Tick,1740,1799,-59,59,140500,140000,19087,787813,776013,OK
634.780666,delay,Tick,1740,1809,-69,69,140500,140000,19368,791532,777732,OK
634.967817,delay,Tick,1740,1819,-79,79,140500,140000,19649,795251,779451,OK
635.261735,delay,Tick,1740,1825,-85,85,140500,140000,19818,797482,780482,OK
635.487291,delay,Tick,1740,1825,-85,85,140100,140000,19818,797482,788982,OK
635.770525,delay,Tick,1740,1830,-90,90,140600,140000,19748,799052,781052,OK
635.996771,delay,Tick,1740,1830,-90,90,140600,140000,19748,799052,781052,OK
636.251188,delay,Tick,1740,1830,-90,90,140600,140000,19748,799052,781052,OK
636.508321,delay,Tick,1740,1830,-90,90,140600,140000,19748,799052,781052,OK
636.775232,delay,Tick,1740,1830,-90,90,140600,140000,19748,799052,781052,OK
636.990332,delay,Tick,1740,1830,-90,90,140600,140000,19748,799052,781052,OK
637.244596,delay,Tick,1740,1830,-90,90,140100,140000,19748,799052,790052,OK
637.474785,delay,Tick,1740,1830,-90,90,140100,140000,19748,799052,790052,OK
637.755706,delay,Tick,1740,1830,-90,90,140100,140000,19748,799052,790052,OK
638.033629,delay,Tick,1740,1830,-90,90,140100,140000,19748,799052,790052,OK
638.218628,delay,Tick,1740,1830,-90,90,140100,140000,19748,799052,790052,OK
638.460947,delay,Tick,1740,1830,-90,90,140100,140000,19748,799052,790052,OK
638.759442,delay,Tick,1740,1830,-90,90,140100,140000,19748,799052,790052,OK
638.996187,delay,Tick,1740,1830,-90,90,140100,140000,19748,799052,790052,OK
639.213372,delay,Tick,1740,1830,-90,90,140100,140000,19748,799052,790052,OK
639.545211,delay,Tick,1740,1830,-90,90,140100,140000,19748,799052,790052,OK
639.738821,delay,Tick,1740,1830,-90,90,140100,140000,19748,799052,790052,OK
640.050575,delay,Tick,1740,1830,-90,90,140100,139900,19748,799052,781052,OK
640.293983,delay,Tick,1740,1830,-90,90,140100,139900,19748,799052,781052,OK
640.544438,delay,Tick,1740,1830,-90,90,140100,139900,19748,799052,781052,OK
640.774502,delay,Tick,1740,1830,-90,90,140100,139900,19748,799052,781052,OK
641.030569,delay,Tick,1740,1830,-90,90,140100,139900,19748,799052,781052,OK
641.286203,delay,Tick,1740,1830,-90,90,140100,140000,19748,799052,790052,OK
641.46752,delay,Tick,1740,1830,-90,90,140100,140000,19748,799052,790052,OK
641.738318,delay,Tick,1740,1830,-90,90,140100,140000,19748,799052,790052,OK
641.958338,delay,Tick,1747,1830,-83,83,139800,140000,19650,800550,817150,OK
642.225328,delay,Tick,1747,1830,-83,83,139800,140000,19650,800550,817150,OK
642.488764,delay,Tick,1747,1830,-83,83,139800,140000,19650,800550,817150,OK
642.755194,delay,Tick,1747,1830,-83,83,140400,140000,19650,800550,783950,OK
642.963993,delay,Tick,1747,1830,-83,83,140400,140100,19650,800550,783950,OK
643.297907,delay,Tick,1747,1830,-83,83,140400,140100,19650,800550,783950,OK
643.505811,delay,Tick,1747,1830,-83,83,140400,140100,19650,800550,783950,OK
643.712641,delay,Tick,1747,1830,-83,83,140400,140100,19650,800550,783950,OK
644.012121,delay,Tick,1812,1830,-18,18,139900,140100,18741,814459,818059,OK
644.260136,delay,Tick,1812,1830,-18,18,139900,140100,18741,814459,818059,OK
644.483643,delay,Tick,1812,1830,-18,18,139900,140100,18741,814459,818059,OK
644.741371,delay,Tick,1812,1830,-18,18,140500,140100,18741,814459,810859,OK
644.987362,delay,Tick,1812,1830,-18,18,140500,140100,18741,814459,810859,OK
645.248343,delay,Tick,1812,1830,-18,18,140500,140100,18741,814459,810859,OK
645.528571,delay,Tick,1812,1830,-18,18,140500,140100,18741,814459,810859,OK
645.736734,delay,Tick,1812,1830,-18,18,140500,140100,18741,814459,810859,OK
645.954086,delay,Tick,1812,1830,-18,18,140300,140100,18741,814459,810859,OK
646.22662,delay,Tick,1822,1830,-8,8,139600,140100,18601,816599,818199,OK
646.500197,delay,Tick,1822,1830,-8,8,139600,140100,18601,816599,818199,OK
646.733035,delay,Tick,1822,1830,-8,8,139600,140100,18601,816599,818199,OK
647.02753,delay,Tick,1822,1830,-8,8,139600,140000,18601,816599,818199,OK
647.286131,delay,Tick,1822,1840,-18,18,140200,140000,18881,818319,814719,OK
647.52627,delay,Tick,1822,1850,-28,28,140200,140000,19161,819039,813439,OK
647.778736,delay,Tick,1822,1860,-38,38,140200,139900,19441,821759,814159,OK
647.979251,delay,Tick,1822,1860,-38,38,140200,139900,19441,821759,814159,OK
648.289816,delay,Tick,1822,1860,-38,38,140200,139900,19441,821759,814159,OK
648.534927,delay,Tick,1822,1870,-48,48,140200,139900,19721,824479,814879,OK
648.790766,delay,Tick,1822,1880,-58,58,140200,139900,20001,827199,815599,OK
648.976426,delay,Tick,1822,1890,-68,68,140200,139900,20281,828919,815319,OK
649.222767,delay,Tick,1822,1900,-78,78,140200,139900,20561,831639,816039,OK
649.527826,delay,Tick,1822,1910,-88,88,140200,139900,20841,834359,816759,OK
649.73137,delay,Tick,1822,1912,-90,90,140100,139900,20897,834703,816703,OK
650.024828,delay,Tick,1822,1912,-90,90,140100,139900,20897,834703,816703,OK
650.294471,delay,Tick,1822,1912,-90,90,140100,139900,20897,834703,816703,OK
650.492171,delay,Tick,1822,1912,-90,90,140300,139900,20897,834703,816703,OK
650.760427,delay,Tick,1822,1912,-90,90,140300,139900,20897,834703,816703,OK
651.024968,delay,Tick,1822,1912,-90,90,140300,139900,20897,834703,816703,OK
651.226376,delay,Tick,1822,1912,-90,90,140100,139900,20897,834703,816703,OK
651.493944,delay,Tick,1822,1912,-90,90,140100,139900,20897,834703,816703,OK
651.728339,delay,Tick,1822,1912,-90,90,140100,139900,20897,834703,816703,OK
651.97348,delay,Tick,1822,1912,-90,90,140100,139900,20897,834703,816703,OK
652.273317,delay,Tick,1822,1912,-90,90,140100,139900,20897,834703,816703,OK
652.454049,delay,Tick,1822,1912,-90,90,140100,139500,20897,834703,816703,OK
652.730017,delay,Tick,1822,1912,-90,90,140100,139600,20897,834703,816703,OK
652.961406,delay,Tick,1822,1912,-90,90,140100,139600,20897,834703,816703,OK
653.229423,delay,Tick,1822,1912,-90,90,140100,139600,20897,834703,816703,OK
653.537532,delay,Tick,1822,1912,-90,90,140100,139600,20897,834703,816703,OK
653.763527,delay,Tick,1822,1912,-90,90,140100,139600,20897,834703,816703,OK
653.996181,delay,Tick,1822,1912,-90,90,140100,139600,20897,834703,816703,OK
654.212597,delay,Tick,1822,1912,-90,90,139600,139600,20897,834703,834703,OK
654.483702,delay,Tick,1822,1912,-90,90,139600,139600,20897,834703,834703,OK
654.724216,delay,Tick,1822,1912,-90,90,139500,139600,20897,834703,843703,OK
655.026115,delay,Tick,1822,1912,-90,90,139500,139600,20897,834703,843703,OK
655.284557,delay,Tick,1822,1912,-90,90,139500,139600,20897,834703,843703,OK
655.508332,delay,Tick,1822,1912,-90,90,139500,139600,20897,834703,843703,OK
655.77659,delay,Tick,1822,1912,-90,90,139500,139600,20897,834703,843703,OK
656.03979,delay,Tick,1822,1912,-90,90,139600,139600,20897,834703,834703,OK
656.296753,delay,Tick,1822,1912,-90,90,139600,139600,20897,834703,834703,OK
656.548913,delay,Tick,1822,1912,-90,90,139600,139600,20897,834703,834703,OK
656.728246,delay,Tick,1822,1912,-90,90,139600,139600,20897,834703,834703,OK
656.97517,delay,Tick,1822,1912,-90,90,139600,139600,20897,834703,834703,OK
657.254408,delay,Tick,1822,1912,-90,90,139500,139600,20897,834703,843703,OK
657.472952,delay,Tick,1822,1912,-90,90,139500,139600,20897,834703,843703,OK
657.714375,delay,Tick,1822,1912,-90,90,139500,139600,20897,834703,843703,OK
657.964888,delay,Tick,1822,1912,-90,90,139500,139600,20897,834703,843703,OK
658.284417,delay,Tick,1822,1912,-90,90,139500,139600,20897,834703,843703,OK
658.513162,delay,Tick,1822,1912,-90,90,139500,139600,20897,834703,843703,OK
658.788773,delay,Tick,1822,1912,-90,90,139500,139500,20897,834703,834703,OK
659.028966,delay,Tick,1822,1912,-90,90,139500,139500,20897,834703,834703,OK
659.285804,delay,Tick,1822,1912,-90,90,139500,139500,20897,834703,834703,OK
659.486368,delay,Tick,1822,1912,-90,90,139500,139500,20897,834703,834703,OK
659.74889,delay,Tick,1822,1912,-90,90,139500,139500,20897,834703,834703,OK
659.977731,delay,Tick,1822,1912,-90,90,139800,139500,20897,834703,816703,OK
660.288737,delay,Tick,1822,1912,-90,90,139800,139500,20897,834703,816703,OK
660.478651,delay,Tick,1822,1912,-90,90,139800,139500,20897,834703,816703,OK
660.739472,delay,Tick,1822,1912,-90,90,139800,139500,20897,834703,816703,OK
660.955653,delay,Tick,1822,1912,-90,90,139800,139500,20897,834703,816703,OK
661.292943,delay,Tick,1822,1912,-90,90,139800,139500,20897,834703,816703,OK
661.533007,delay,Tick,1822,1912,-90,90,139800,139500,20897,834703,816703,OK
661.737179,delay,Tick,1822,1912,-90,90,139800,139500,20897,834703,816703,OK
662.043616,delay,Tick,1822,1912,-90,90,139800,139400,20897,834703,816703,OK
662.223455,delay,Tick,1822,1912,-90,90,139800,139400,20897,834703,816703,OK
662.456858,delay,Tick,1822,1912,-90,90,139800,139400,20897,834703,816703,OK
662.763258,delay,Tick,1822,1912,-90,90,139800,139200,20897,834703,816703,OK
662.992158,delay,Tick,1822,1912,-90,90,139800,139200,20897,834703,816703,OK
663.301198,delay,Tick,1822,1912,-90,90,139800,139200,20897,834703,816703,OK
663.453069,delay,Tick,1822,1912,-90,90,139800,139200,20897,834703,816703,OK
663.795995,delay,Tick,1822,1912,-90,90,139800,139200,20897,834703,816703,OK
663.983757,delay,Tick,1822,1912,-90,90,139800,139200,20897,834703,816703,OK
664.269126,delay,Tick,1822,1912,-90,90,139800,139200,20897,834703,816703,OK
664.516454,delay,Tick,1822,1912,-90,90,139800,139200,20897,834703,816703,OK
664.717176,delay,Tick,1822,1912,-90,90,139800,139200,20897,834703,816703,OK
664.973169,delay,Tick,1822,1912,-90,90,139800,139200,20897,834703,816703,OK
665.210826,delay,Tick,1822,1912,-90,90,139800,139200,20897,834703,816703,OK
665.486736,delay,Tick,1822,1912,-90,90,139800,139600,20897,834703,816703,OK
665.765361,delay,Tick,1822,1912,-90,90,139800,139600,20897,834703,816703,OK
665.985732,delay,Tick,1822,1912,-90,90,139800,139600,20897,834703,816703,OK
666.294902,delay,Tick,1822,1912,-90,90,139800,139600,20897,834703,816703,OK
666.480757,delay,Tick,1822,1912,-90,90,139800,139600,20897,834703,816703,OK
666.791134,delay,Tick,1822,1912,-90,90,139800,139600,20897,834703,816703,OK
667.031377,delay,Tick,1822,1912,-90,90,139800,139600,20897,834703,816703,OK
667.224975,delay,Tick,1822,1912,-90,90,139900,139600,20897,834703,816703,OK
667.472594,delay,Tick,1822,1912,-90,90,139900,139600,20897,834703,816703,OK
667.732937,delay,Tick,1822,1912,-90,90,140000,139600,20897,834703,816703,OK
667.991194,delay,Tick,1822,1912,-90,90,140000,139600,20897,834703,816703,OK
668.270919,delay,Tick,1822,1912,-90,90,140000,139600,20897,834703,816703,OK
668.525975,delay,Tick,1822,1912,-90,90,140000,139600,20897,834703,816703,OK
668.704695,delay,Tick,1822,1912,-90,90,140000,139600,20897,834703,816703,OK
668.952844,delay,Tick,1822,1912,-90,90,140000,139600,20897,834703,816703,OK
669.29672,delay,Tick,1822,1912,-90,90,140000,139600,20897,834703,816703,OK
669.510927,delay,Tick,1822,1912,-90,90,139500,139600,20897,834703,843703,OK
669.718498,delay,Tick,1822,1912,-90,90,139500,139600,20897,834703,843703,OK
670.031976,delay,Tick,1822,1912,-90,90,139500,139400,20897,834703,825703,OK
670.215937,delay,Tick,1822,1912,-90,90,139500,139400,20897,834703,825703,OK
670.538382,delay,Tick,1822,1912,-90,90,139500,139400,20897,834703,825703,OK
670.787493,delay,Tick,1822,1912,-90,90,139500,139400,20897,834703,825703,OK
671.026731,delay,Tick,1822,1912,-90,90,139500,139400,20897,834703,825703,OK
671.231739,delay,Tick,1822,1912,-90,90,139500,139400,20897,834703,825703,OK
671.529375,delay,Tick,1822,1912,-90,90,139500,139400,20897,834703,825703,OK
671.752275,delay,Tick,1822,1912,-90,90,139400,139400,20897,834703,834703,OK
671.997719,delay,Tick,1822,1912,-90,90,139400,139400,20897,834703,834703,OK
672.204707,delay,Tick,1822,1912,-90,90,139400,139300,20897,834703,825703,OK
672.532149,delay,Tick,1822,1912,-90,90,139800,139300,20897,834703,816703,OK
672.742783,delay,Tick,1822,1912,-90,90,139800,139300,20897,834703,816703,OK
673.024545,delay,Tick,1822,1912,-90,90,139800,139100,20897,834703,816703,OK
673.277648,delay,Tick,1822,1912,-90,90,139800,139100,20897,834703,816703,OK
673.496144,delay,Tick,1822,1912,-90,90,139800,139100,20897,834703,816703,OK
673.703942,delay,Tick,1822,1912,-90,90,139400,139100,20897,834703,816703,OK
674.010949,delay,Tick,1822,1912,-90,90,139400,139100,20897,834703,816703,OK
674.204135,delay,Tick,1822,1912,-90,90,139400,139100,20897,834703,816703,OK
674.476929,delay,Tick,1822,1912,-90,90,139400,139100,20897,834703,816703,OK
674.715484,delay,Tick,1822,1912,-90,90,139800,139100,20897,834703,816703,OK
675.048132,delay,Tick,1822,1912,-90,90,139800,139100,20897,834703,816703,OK
675.243478,delay,Tick,1822,1912,-90,90,139800,139100,20897,834703,816703,OK
675.459178,delay,Tick,1822,1912,-90,90,139800,139100,20897,834703,816703,OK
675.738289,delay,Tick,1822,1912,-90,90,139400,139100,20897,834703,816703,OK
675.996752,delay,Tick,1822,1912,-90,90,139400,139100,20897,834703,816703,OK
676.270639,delay,Tick,1822,1912,-90,90,139400,139100,20897,834703,816703,OK
676.49532,delay,Tick,1822,1912,-90,90,139500,139100,20897,834703,816703,OK
676.799695,delay,Tick,1822,1912,-90,90,139500,139100,20897,834703,816703,OK
677.041815,delay,Tick,1822,1912,-90,90,139500,139100,20897,834703,816703,OK
677.235517,delay,Tick,1822,1912,-90,90,139500,139100,20897,834703,816703,OK
677.456782,delay,Tick,1822,1912,-90,90,139500,139100,20897,834703,816703,OK
677.734528,delay,Tick,1822,1912,-90,90,139500,139100,20897,834703,816703,OK
678.04569,delay,Tick,1822,1912,-90,90,139500,139100,20897,834703,816703,OK
678.287434,delay,Tick,1822,1912,-90,90,139500,139100,20897,834703,816703,OK
678.51217,delay,Tick,1822,1912,-90,90,139600,139100,20897,834703,816703,OK
678.748053,delay,Tick,1822,1912,-90,90,139600,139100,20897,834703,816703,OK
679.035141,delay,Tick,1822,1912,-90,90,139600,139100,20897,834703,816703,OK
679.290553,delay,Tick,1822,1912,-90,90,139600,139100,20897,834703,816703,OK
679.535247,delay,Tick,1822,1912,-90,90,139600,139100,20897,834703,816703,OK
679.790561,delay,Tick,1822,1912,-90,90,139600,139100,20897,834703,816703,OK
680.002241,delay,Tick,1822,1912,-90,90,139600,139100,20897,834703,816703,OK
680.258812,delay,Tick,1822,1912,-90,90,139600,139000,20897,834703,816703,OK
680.466112,delay,Tick,1822,1912,-90,90,139600,139000,20897,834703,816703,OK
680.762897,delay,Tick,1822,1912,-90,90,139600,139000,20897,834703,816703,OK
680.997854,delay,Tick,1822,1912,-90,90,139600,139000,20897,834703,816703,OK
681.218765,delay,Tick,1822,1912,-90,90,139600,139000,20897,834703,816703,OK
681.512553,delay,Tick,1822,1912,-90,90,139600,139000,20897,834703,816703,OK
681.71901,delay,Tick,1822,1912,-90,90,139600,139000,20897,834703,816703,OK
681.992321,delay,Tick,1822,1912,-90,90,139600,139000,20897,834703,816703,OK
682.29273,delay,Tick,1822,1912,-90,90,139400,139000,20897,834703,816703,OK
682.516874,delay,Tick,1822,1912,-90,90,139400,139000,20897,834703,816703,OK
682.800086,delay,Tick,1822,1912,-90,90,139400,139000,20897,834703,816703,OK
683.027693,delay,Tick,1822,1912,-90,90,139400,139000,20897,834703,816703,OK
683.216681,delay,Tick,1822,1912,-90,90,139400,139000,20897,834703,816703,OK
683.521551,delay,Tick,1822,1912,-90,90,139400,139100,20897,834703,816703,OK
683.702842,delay,Tick,1822,1912,-90,90,139400,139100,20897,834703,816703,OK
684.043954,delay,Tick,1822,1912,-90,90,139400,139100,20897,834703,816703,OK
684.243101,delay,Tick,1822,1912,-90,90,139400,139100,20897,834703,816703,OK
684.549314,delay,Tick,1822,1912,-90,90,139400,139100,20897,834703,816703,OK
684.752942,delay,Tick,1822,1912,-90,90,139400,139100,20897,834703,816703,OK
684.952656,delay,Tick,1822,1912,-90,90,139400,139100,20897,834703,816703,OK
685.26952,delay,Tick,1822,1912,-90,90,139400,139100,20897,834703,816703,OK
685.485211,delay,Tick,1822,1912,-90,90,139400,139100,20897,834703,816703,OK
685.792089,delay,Tick,1822,1912,-90,90,139400,139100,20897,834703,816703,OK
685.988596,delay,Tick,1822,1912,-90,90,139400,139100,20897,834703,816703,OK
686.269746,delay,Tick,1822,1912,-90,90,139400,138700,20897,834703,816703,OK
686.540251,delay,Tick,1822,1912,-90,90,139200,138700,20897,834703,816703,OK
686.778522,delay,Tick,1822,1912,-90,90,139200,138700,20897,834703,816703,OK
686.972471,delay,Tick,1822,1912,-90,90,139100,138700,20897,834703,816703,OK
687.235599,delay,Tick,1822,1912,-90,90,139100,138700,20897,834703,816703,OK
687.520287,delay,Tick,1822,1912,-90,90,139100,138700,20897,834703,816703,OK
687.766006,delay,Tick,1822,1912,-90,90,139100,138700,20897,834703,816703,OK
688.046197,delay,Tick,1822,1912,-90,90,139100,138700,20897,834703,816703,OK
688.292886,delay,Tick,1822,1912,-90,90,139100,138700,20897,834703,816703,OK
688.49445,delay,Tick,1822,1912,-90,90,139100,138700,20897,834703,816703,OK
688.703329,delay,Tick,1822,1912,-90,90,139000,138700,20897,834703,816703,OK
689.032048,delay,Tick,1822,1912,-90,90,139000,138700,20897,834703,816703,OK
689.235857,delay,Tick,1822,1912,-90,90,139000,138500,20897,834703,816703,OK
689.510221,delay,Tick,1822,1912,-90,90,139000,138500,20897,834703,816703,OK
689.734432,delay,Tick,1822,1912,-90,90,139000,138500,20897,834703,816703,OK
690.021422,delay,Tick,1822,1912,-90,90,139000,138500,20897,834703,816703,OK
690.296603,delay,Tick,1822,1912,-90,90,139000,138400,20897,834703,816703,OK
690.462288,delay,Tick,1822,1912,-90,90,139000,138500,20897,834703,816703,OK
690.729269,delay,Tick,1822,1912,-90,90,139000,138500,20897,834703,816703,OK
691.028331,delay,Tick,1822,1912,-90,90,139000,138500,20897,834703,816703,OK
691.221666,delay,Tick,1822,1912,-90,90,139000,138500,20897,834703,816703,OK
691.542934,delay,Tick,1822,1912,-90,90,139000,138500,20897,834703,816703,OK
691.73344,delay,Tick,1822,1912,-90,90,139000,138500,20897,834703,816703,OK
692.009339,delay,Tick,1822,1912,-90,90,139000,138500,20897,834703,816703,OK
692.237062,delay,Tick,1822,1912,-90,90,139000,138500,20897,834703,816703,OK
692.52582,delay,Tick,1822,1912,-90,90,139000,138500,20897,834703,816703,OK
692.746366,delay,Tick,1822,1912,-90,90,139000,138500,20897,834703,816703,OK
693.002444,delay,Tick,1822,1912,-90,90,139000,138500,20897,834703,816703,OK
693.282413,delay,Tick,1822,1912,-90,90,139000,138500,20897,834703,816703,OK
693.483993,delay,Tick,1822,1912,-90,90,139200,138500,20897,834703,816703,OK
693.771876,delay,Tick,1822,1912,-90,90,139200,138500,20897,834703,816703,OK
693.999151,delay,Tick,1822,1912,-90,90,139200,138500,20897,834703,816703,OK
694.284596,delay,Tick,1822,1912,-90,90,139200,138500,20897,834703,816703,OK
694.497793,delay,Tick,1822,1912,-90,90,139200,138500,20897,834703,816703,OK
694.74833,delay,Tick,1822,1912,-90,90,139200,138500,20897,834703,816703,OK
695.043865,delay,Tick,1822,1912,-90,90,138900,138600,20897,834703,816703,OK
695.202831,delay,Tick,1822,1912,-90,90,138900,138600,20897,834703,816703,OK
695.460649,delay,Tick,1822,1912,-90,90,138900,138600,20897,834703,816703,OK
695.751099,delay,Tick,1822,1912,-90,90,138900,138600,20897,834703,816703,OK
696.016695,delay,Tick,1822,1912,-90,90,139100,138600,20897,834703,816703,OK
696.320424,delay,Tick,1822,1912,-90,90,139100,138600,20897,834703,816703,OK
696.515684,delay,Tick,1822,1912,-90,90,139100,138600,20897,834703,816703,OK
696.787098,delay,Tick,1822,1912,-90,90,139100,139000,20897,834703,825703,OK
696.982826,delay,Tick,1822,1912,-90,90,139100,139000,20897,834703,825703,OK
697.270417,delay,Tick,1822,1912,-90,90,139100,139000,20897,834703,825703,OK
697.491513,delay,Tick,1822,1912,-90,90,139100,139000,20897,834703,825703,OK
697.799709,delay,Tick,1822,1912,-90,90,139100,138900,20897,834703,816703,OK
697.987831,delay,Tick,1822,1912,-90,90,138900,138900,20897,834703,834703,OK
698.259132,delay,Tick,1822,1912,-90,90,138900,139000,20897,834703,843703,OK
698.47483,delay,Tick,1822,1912,-90,90,138900,139000,20897,834703,843703,OK
698.792465,delay,Tick,1822,1912,-90,90,138900,139000,20897,834703,843703,OK
699.038804,delay,Tick,1822,1912,-90,90,138900,139200,20897,834703,852703,OK
699.289949,delay,Tick,1822,1912,-90,90,138900,139200,20897,834703,852703,OK
699.457455,delay,Tick,1822,1912,-90,90,138900,139200,20897,834703,852703,OK
699.770321,delay,Tick,1822,1912,-90,90,138900,139200,20897,834703,852703,OK
700.033444,delay,Tick,1822,1912,-90,90,138900,139200,20897,834703,852703,OK
700.221216,delay,Tick,1822,1912,-90,90,138900,139000,20897,834703,843703,OK
700.516755,delay,Tick,1822,1912,-90,90,139600,139000,20897,834703,816703,OK
700.772047,delay,Tick,1822,1912,-90,90,139600,139000,20897,834703,816703,OK
701.048553,delay,Tick,1822,1912,-90,90,138900,139000,20897,834703,843703,OK
701.241687,delay,Tick,1822,1912,-90,90,138900,139000,20897,834703,843703,OK
701.537794,delay,Tick,1822,1912,-90,90,138900,139000,20897,834703,843703,OK
701.742699,delay,Tick,1822,1912,-90,90,139600,139000,20897,834703,816703,OK
702.043595,delay,Tick,1822,1912,-90,90,139600,138900,20897,834703,816703,OK
702.21431,delay,Tick,1822,1912,-90,90,139600,138900,20897,834703,816703,OK
702.476329,delay,Tick,1822,1912,-90,90,139600,138900,20897,834703,816703,OK
702.767752,delay,Tick,1822,1912,-90,90,139200,138900,20897,834703,816703,OK
702.956591,delay,Tick,1822,1912,-90,90,139200,138900,20897,834703,816703,OK
703.230621,delay,Tick,1822,1912,-90,90,139200,138900,20897,834703,816703,OK
703.509582,delay,Tick,1822,1912,-90,90,139200,138900,20897,834703,816703,OK
703.766159,delay,Tick,1822,1912,-90,90,139200,138900,20897,834703,816703,OK
704.002456,delay,Tick,1822,1912,-90,90,139200,138900,20897,834703,816703,OK
704.23445,delay,Tick,1822,1912,-90,90,139200,138900,20897,834703,816703,OK
704.521357,delay,Tick,1822,1912,-90,90,139200,138900,20897,834703,816703,OK
704.741777,delay,Tick,1822,1912,-90,90,139200,138900,20897,834703,816703,OK
704.977379,delay,Tick,1822,1912,-90,90,139200,138900,20897,834703,816703,OK
705.28851,delay,Tick,1822,1912,-90,90,139200,138600,20897,834703,816703,OK
705.515316,delay,Tick,1822,1912,-90,90,139200,138500,20897,834703,816703,OK
705.71349,delay,Tick,1822,1912,-90,90,139000,138500,20897,834703,816703,OK
705.994968,delay,Tick,1822,1912,-90,90,139000,138500,20897,834703,816703,OK
706.211476,delay,Tick,1822,1912,-90,90,139000,138300,20897,834703,816703,OK
706.471646,delay,Tick,1822,1912,-90,90,139000,138300,20897,834703,816703,OK
706.771668,delay,Tick,1822,1912,-90,90,139000,138300,20897,834703,816703,OK
706.997505,delay,Tick,1822,1912,-90,90,139000,138300,20897,834703,816703,OK
707.224885,delay,Tick,1822,1912,-90,90,138900,138300,20897,834703,816703,OK
707.451259,delay,Tick,1822,1912,-90,90,138900,138300,20897,834703,816703,OK
707.740988,delay,Tick,1822,1912,-90,90,138900,138300,20897,834703,816703,OK
708.008845,delay,Tick,1822,1912,-90,90,138900,138300,20897,834703,816703,OK
708.274511,delay,Tick,1822,1912,-90,90,138900,138300,20897,834703,816703,OK
708.492964,delay,Tick,1822,1912,-90,90,138900,138300,20897,834703,816703,OK
708.72293,delay,Tick,1822,1912,-90,90,138900,138300,20897,834703,816703,OK
708.974909,delay,Tick,1822,1912,-90,90,138900,138300,20897,834703,816703,OK
709.231678,delay,Tick,1822,1912,-90,90,139000,138300,20897,834703,816703,OK
709.545285,delay,Tick,1822,1912,-90,90,138900,138300,20897,834703,816703,OK
709.783366,delay,Tick,1822,1912,-90,90,138900,138300,20897,834703,816703,OK
709.970182,delay,Tick,1822,1912,-90,90,138900,138300,20897,834703,816703,OK
710.20938,delay,Tick,1822,1912,-90,90,138900,138300,20897,834703,816703,OK
710.472055,delay,Tick,1822,1912,-90,90,138900,138300,20897,834703,816703,OK
710.777058,delay,Tick,1822,1912,-90,90,138900,138300,20897,834703,816703,OK
711.005157,delay,Tick,1822,1912,-90,90,138900,138300,20897,834703,816703,OK
711.254197,delay,Tick,1822,1912,-90,90,138900,138300,20897,834703,816703,OK
711.510347,delay,Tick,1822,1912,-90,90,138900,138300,20897,834703,816703,OK
711.70119,delay,Tick,1822,1912,-90,90,138900,138300,20897,834703,816703,OK
711.98418,delay,Tick,1822,1912,-90,90,138900,138300,20897,834703,816703,OK
712.268558,delay,Tick,1822,1912,-90,90,138900,138300,20897,834703,816703,OK
712.478057,delay,Tick,1822,1912,-90,90,138900,138300,20897,834703,816703,OK
712.744234,delay,Tick,1822,1912,-90,90,138900,138300,20897,834703,816703,OK
712.968237,delay,Tick,1822,1912,-90,90,138900,138300,20897,834703,816703,OK
713.286287,delay,Tick,1822,1912,-90,90,138900,138300,20897,834703,816703,OK
713.545462,delay,Tick,1822,1912,-90,90,138900,138300,20897,834703,816703,OK
713.776077,delay,Tick,1822,1912,-90,90,138900,138300,20897,834703,816703,OK
713.969677,delay,Tick,1822,1912,-90,90,138900,138300,20897,834703,816703,OK
714.276057,delay,Tick,1822,1912,-90,90,138900,138300,20897,834703,816703,OK
714.48089,delay,Tick,1822,1912,-90,90,138900,138300,20897,834703,816703,OK
714.710716,delay,Tick,1822,1912,-90,90,139400,138300,20897,834703,816703,OK
714.984769,delay,Tick,1822,1912,-90,90,139100,138900,20897,834703,816703,OK
715.266256,delay,Tick,1822,1912,-90,90,139100,138900,20897,834703,816703,OK
715.538072,delay,Tick,1822,1912,-90,90,139100,139000,20897,834703,825703,OK
715.732459,delay,Tick,1822,1912,-90,90,139100,139000,20897,834703,825703,OK
716.021116,delay,Tick,1822,1912,-90,90,139100,139000,20897,834703,825703,OK
716.235129,delay,Tick,1822,1912,-90,90,139100,139000,20897,834703,825703,OK
716.493172,delay,Tick,1822,1912,-90,90,139100,139000,20897,834703,825703,OK
716.760304,delay,Tick,1822,1912,-90,90,139100,139000,20897,834703,825703,OK
717.039506,delay,Tick,1822,1912,-90,90,139100,139000,20897,834703,825703,OK
717.291277,delay,Tick,1822,1912,-90,90,139100,139000,20897,834703,825703,OK
717.455139,delay,Tick,1822,1912,-90,90,139100,139000,20897,834703,825703,OK
717.77945,delay,Tick,1822,1912,-90,90,139100,139000,20897,834703,825703,OK
718.023527,delay,Tick,1822,1912,-90,90,139100,139000,20897,834703,825703,OK
718.273559,delay,Tick,1822,1912,-90,90,139100,139000,20897,834703,825703,OK
718.543728,delay,Tick,1822,1912,-90,90,139100,139000,20897,834703,825703,OK
718.779424,delay,Tick,1822,1912,-90,90,139100,139200,20897,834703,843703,OK
718.992538,delay,Tick,1822,1912,-90,90,139100,139200,20897,834703,843703,OK
719.29056,delay,Tick,1822,1912,-90,90,139100,139200,20897,834703,843703,OK
719.512486,delay,Tick,1822,1912,-90,90,139100,139200,20897,834703,843703,OK
719.745427,delay,Tick,1822,1912,-90,90,139100,139200,20897,834703,843703,OK
719.977242,delay,Tick,1822,1912,-90,90,139100,139200,20897,834703,843703,OK
720.273189,delay,Tick,1822,1912,-90,90,139100,138900,20897,834703,816703,OK
720.479768,delay,Tick,1822,1912,-90,90,139100,138900,20897,834703,816703,OK
720.801457,delay,Tick,1822,1912,-90,90,138800,138900,20897,834703,843703,OK
721.022643,delay,Tick,1822,1912,-90,90,139200,138900,20897,834703,816703,OK
721.27634,delay,Tick,1822,1912,-90,90,139200,138900,20897,834703,816703,OK
721.505693,delay,Tick,1822,1912,-90,90,139200,138900,20897,834703,816703,OK
721.786376,delay,Tick,1822,1912,-90,90,139200,138900,20897,834703,816703,OK
721.98789,delay,Tick,1822,1912,-90,90,139200,138900,20897,834703,816703,OK
722.295887,delay,Tick,1822,1912,-90,90,139200,138900,20897,834703,816703,OK
722.458564,delay,Tick,1822,1912,-90,90,139200,139000,20897,834703,816703,OK
722.78349,delay,Tick,1822,1912,-90,90,139500,139000,20897,834703,816703,OK
722.951241,delay,Tick,1822,1912,-90,90,139500,139000,20897,834703,816703,OK
723.263302,delay,Tick,1853,1912,-59,59,138900,139000,20466,841334,847234,OK
723.488603,delay,Tick,1853,1912,-59,59,138900,139000,20466,841334,847234,OK
723.715627,delay,Tick,1853,1912,-59,59,139100,139000,20466,841334,835434,OK
723.982615,delay,Tick,1853,1912,-59,59,139100,139000,20466,841334,835434,OK
724.204343,delay,Tick,1853,1912,-59,59,139100,139000,20466,841334,835434,OK
724.485526,delay,Tick,1853,1912,-59,59,139100,139000,20466,841334,835434,OK
724.799891,delay,Tick,1853,1912,-59,59,139100,139100,20466,841334,841334,OK
725.033616,delay,Tick,1853,1912,-59,59,139100,139100,20466,841334,841334,OK
725.272753,delay,Tick,1853,1912,-59,59,139000,139100,20466,841334,847234,OK
725.474525,delay,Tick,1853,1912,-59,59,139000,139100,20466,841334,847234,OK
725.794613,delay,Tick,1853,1912,-59,59,139000,139100,20466,841334,847234,OK
725.971995,delay,Tick,1853,1912,-59,59,139000,139100,20466,841334,847234,OK
726.277312,delay,Tick,1853,1912,-59,59,139000,139100,20466,841334,847234,OK
726.467012,delay,Tick,1853,1912,-59,59,139000,139100,20466,841334,847234,OK
726.796951,delay,Tick,1853,1912,-59,59,139000,139700,20466,841334,853134,OK
727.029691,delay,Tick,1853,1912,-59,59,139000,139700,20466,841334,853134,OK
727.289209,delay,Tick,1853,1912,-59,59,139000,139700,20466,841334,853134,OK
727.529619,delay,Tick,1853,1912,-59,59,139000,139700,20466,841334,853134,OK
727.767163,delay,Tick,1853,1912,-59,59,139000,139700,20466,841334,853134,OK
727.99875,delay,Tick,1853,1912,-59,59,139000,139700,20466,841334,853134,OK
728.211875,delay,Tick,1853,1912,-59,59,139000,139700,20466,841334,853134,OK
728.537723,delay,Tick,1853,1912,-59,59,139000,139400,20466,841334,853134,OK
728.747526,delay,Tick,1853,1912,-59,59,139000,139400,20466,841334,853134,OK
728.957175,delay,Tick,1853,1912,-59,59,139000,139400,20466,841334,853134,OK
729.222356,delay,Tick,1853,1912,-59,59,139000,139400,20466,841334,853134,OK
729.53535,delay,Tick,1853,1912,-59,59,139000,139400,20466,841334,853134,OK
729.793374,delay,Tick,1853,1912,-59,59,139000,139400,20466,841334,853134,OK
729.955712,delay,Tick,1853,1912,-59,59,139000,139400,20466,841334,853134,OK
730.209053,delay,Tick,1853,1912,-59,59,139000,139500,20466,841334,853134,OK
730.529801,delay,Tick,1853,1912,-59,59,139000,139500,20466,841334,853134,OK
730.794779,delay,Tick,1853,1912,-59,59,139000,139500,20466,841334,853134,OK
730.970896,delay,Tick,1853,1912,-59,59,139000,139500,20466,841334,853134,OK
731.272657,delay,Tick,1853,1912,-59,59,139000,139500,20466,841334,853134,OK
731.526375,delay,Tick,1853,1912,-59,59,139000,139500,20466,841334,853134,OK
731.739053,delay,Tick,1853,1912,-59,59,139000,139500,20466,841334,853134,OK
732.040088,delay,Tick,1853,1912,-59,59,139300,139500,20466,841334,853134,OK
732.241104,delay,Tick,1853,1912,-59,59,139500,139500,20466,841334,841334,OK
732.522044,delay,Tick,1853,1912,-59,59,139500,139500,20466,841334,841334,OK
732.797563,delay,Tick,1853,1912,-59,59,139500,139500,20466,841334,841334,OK
732.959944,delay,Tick,1853,1912,-59,59,139300,139500,20466,841334,853134,OK
733.269996,delay,Tick,1853,1912,-59,59,139300,139500,20466,841334,853134,OK
733.471917,delay,Tick,1853,1912,-59,59,139300,139500,20466,841334,853134,OK
733.730671,delay,Tick,1853,1912,-59,59,139300,139500,20466,841334,853134,OK
734.035358,delay,Tick,1853,1912,-59,59,139300,139500,20466,841334,853134,OK
734.219589,delay,Tick,1853,1912,-59,59,139300,139500,20466,841334,853134,OK
734.522772,delay,Tick,1853,1912,-59,59,139300,139500,20466,841334,853134,OK
734.775982,delay,Tick,1853,1912,-59,59,139500,139400,20466,841334,835434,OK
735.015955,delay,Tick,1853,1912,-59,59,139300,139400,20466,841334,847234,OK
735.244395,delay,Tick,1853,1912,-59,59,139300,139400,20466,841334,847234,OK
735.454418,delay,Tick,1853,1912,-59,59,139300,139400,20466,841334,847234,OK
735.742292,delay,Tick,1853,1912,-59,59,139300,139400,20466,841334,847234,OK
736.032191,delay,Tick,1853,1912,-59,59,139300,139400,20466,841334,847234,OK
736.210839,delay,Tick,1853,1912,-59,59,139300,139300,20466,841334,841334,OK
736.513203,delay,Tick,1853,1912,-59,59,139300,139300,20466,841334,841334,OK
736.796621,delay,Tick,1853,1912,-59,59,139300,139300,20466,841334,841334,OK
737.022375,delay,Tick,1853,1922,-69,69,139500,139300,20327,843473,829673,OK
737.300255,delay,Tick,1853,1922,-69,69,139500,139300,20327,843473,829673,OK
737.549603,delay,Tick,1853,1922,-69,69,139500,139300,20327,843473,829673,OK
737.710685,delay,Tick,1853,1922,-69,69,139500,139200,20327,843473,829673,OK
737.9702,delay,Tick,1863,1922,-59,59,138800,139200,20188,845612,857412,OK
738.202541,delay,Tick,1863,1922,-59,59,138800,139200,20188,845612,857412,OK
738.47826,delay,Tick,1863,1922,-59,59,138800,139200,20188,845612,857412,OK
738.794796,delay,Tick,1863,1922,-59,59,138800,139200,20188,845612,857412,OK
738.97775,delay,Tick,1863,1922,-59,59,138800,139200,20188,845612,857412,OK
739.217786,delay,Tick,1863,1922,-59,59,138800,139200,20188,845612,857412,OK
739.473326,delay,Tick,1873,1932,-59,59,139400,139200,19909,847891,836091,OK
739.779232,delay,Tick,1883,1932,-49,49,139300,139200,20188,849612,844712,OK
739.975987,delay,Tick,1883,1932,-49,49,139300,139200,20188,849612,844712,OK
740.245333,delay,Tick,1883,1932,-49,49,139300,139200,20188,849612,844712,OK
740.465257,delay,Tick,1883,1932,-49,49,139300,139200,20188,849612,844712,OK
740.706414,delay,Tick,1883,1932,-49,49,139300,139200,20188,849612,844712,OK
740.977129,delay,Tick,1883,1932,-49,49,139600,139200,20188,849612,839812,OK
741.240694,delay,Tick,1883,1932,-49,49,139600,139200,20188,849612,839812,OK
741.49817,delay,Tick,1883,1932,-49,49,139900,139200,20188,849612,839812,OK
741.792753,delay,Tick,1883,1932,-49,49,139900,139200,20188,849612,839812,OK
742.006344,delay,Tick,1883,1932,-49,49,139900,140000,20188,849612,854512,OK
742.236556,delay,Tick,1883,1932,-49,49,139900,140000,20188,849612,854512,OK
742.545325,delay,Tick,1883,1932,-49,49,139900,140000,20188,849612,854512,OK
742.756965,delay,Tick,1883,1932,-49,49,139900,140000,20188,849612,854512,OK
742.971506,delay,Tick,1883,1932,-49,49,139900,140000,20188,849612,854512,OK
743.283661,delay,Tick,1883,1932,-49,49,139900,140000,20188,849612,854512,OK
743.498119,delay,Tick,1883,1932,-49,49,139900,140000,20188,849612,854512,OK
743.7663,delay,Tick,1883,1932,-49,49,139900,140000,20188,849612,854512,OK
744.001292,delay,Tick,1893,1932,-39,39,139900,140300,20468,852332,860132,OK
744.258145,delay,Tick,1903,1932,-29,29,139600,140300,20748,856052,861852,OK
744.481409,delay,Tick,1913,1932,-19,19,139900,140300,21028,859772,863572,OK
744.802004,delay,Tick,1923,1932,-9,9,140000,140300,21308,862992,864792,OK
745.009452,delay,Tick,1933,1932,1,-1,140000,140300,21588,865712,865512,OK
745.214264,delay,Tick,1943,1932,11,-11,140000,140300,21868,868432,866232,OK
745.537688,delay,Tick,1953,1932,21,-21,140000,140300,22148,871152,866952,OK
745.709593,delay,Tick,1963,1932,31,-31,140000,140300,22428,873872,867672,OK
746.031954,delay,Tick,1973,1932,41,-41,140000,140300,22708,876592,868392,OK
746.212163,delay,Tick,1983,1932,51,-51,140000,140300,22988,879312,869112,OK
746.53032,delay,Tick,1993,1932,61,-61,140000,140500,23268,882032,869832,OK
746.789689,delay,Tick,2003,1932,71,-71,140000,140500,23548,885752,871552,OK
746.975244,delay,Tick,2013,1932,81,-81,139800,140500,23828,889472,873272,OK
747.236299,delay,Tick,2022,1932,90,-90,140000,140500,24080,892820,874820,OK
747.527835,delay,Tick,2022,1932,90,-90,140000,140600,24080,892820,874820,OK
747.76835,delay,Tick,2022,1932,90,-90,140000,140600,24080,892820,874820,OK
748.035695,delay,Tick,2022,1932,90,-90,140000,140600,24080,892820,874820,OK
748.253678,delay,Tick,2022,1932,90,-90,140000,140600,24080,892820,874820,OK
748.549193,delay,Tick,2022,1932,90,-90,140000,140600,24080,892820,874820,OK
748.734399,delay,Tick,2022,1932,90,-90,140000,140600,24080,892820,874820,OK
748.974143,delay,Tick,2022,1932,90,-90,140000,140600,24080,892820,874820,OK
749.211863,delay,Tick,2022,1932,90,-90,140000,140700,24080,892820,874820,OK
749.547127,delay,Tick,2022,1932,90,-90,140000,140700,24080,892820,874820,OK
749.73028,delay,Tick,2022,1932,90,-90,140000,140700,24080,892820,874820,OK
750.039965,delay,Tick,2022,1932,90,-90,140000,140700,24080,892820,874820,OK
750.270541,delay,Tick,2022,1932,90,-90,140000,140700,24080,892820,874820,OK
750.479417,delay,Tick,2022,1932,90,-90,140000,140700,24080,892820,874820,OK
750.78965,delay,Tick,2022,1932,90,-90,140100,140500,24080,892820,874820,OK
751.017009,delay,Tick,2022,1932,90,-90,140100,140500,24080,892820,874820,OK
751.214284,delay,Tick,2022,1932,90,-90,140100,140500,24080,892820,874820,OK
751.529865,delay,Tick,2022,1932,90,-90,139800,140500,24080,892820,874820,OK
751.79597,delay,Tick,2022,1932,90,-90,139800,140500,24080,892820,874820,OK
752.00479,delay,Tick,2022,1932,90,-90,139800,140500,24080,892820,874820,OK
752.240374,delay,Tick,2022,1932,90,-90,140100,140500,24080,892820,874820,OK
752.483444,delay,Tick,2022,1932,90,-90,140100,140500,24080,892820,874820,OK
752.729559,delay,Tick,2022,1932,90,-90,140100,140500,24080,892820,874820,OK
752.959659,delay,Tick,2022,1932,90,-90,140100,140500,24080,892820,874820,OK
753.240862,delay,Tick,2022,1932,90,-90,140100,140500,24080,892820,874820,OK
753.516827,delay,Tick,2022,1932,90,-90,140100,140600,24080,892820,874820,OK
753.763329,delay,Tick,2022,1932,90,-90,140100,140600,24080,892820,874820,OK
753.975044,delay,Tick,2022,1932,90,-90,140100,140600,24080,892820,874820,OK
754.246713,delay,Tick,2022,1932,90,-90,140100,140600,24080,892820,874820,OK
754.494728,delay,Tick,2022,1932,90,-90,140100,140600,24080,892820,874820,OK
754.707721,delay,Tick,2022,1932,90,-90,140100,140600,24080,892820,874820,OK
755.049835,delay,Tick,2022,1932,90,-90,140100,140600,24080,892820,874820,OK
755.293313,delay,Tick,2022,1932,90,-90,140100,140600,24080,892820,874820,OK
755.465922,delay,Tick,2022,1932,90,-90,140100,140600,24080,892820,874820,OK
755.788899,delay,Tick,2022,1932,90,-90,140100,140600,24080,892820,874820,OK
756.02931,delay,Tick,2022,1932,90,-90,140200,140600,24080,892820,874820,OK
756.284229,delay,Tick,2022,1932,90,-90,140200,140600,24080,892820,874820,OK
756.471817,delay,Tick,2022,1932,90,-90,140200,140600,24080,892820,874820,OK
756.747953,delay,Tick,2022,1932,90,-90,140200,140600,24080,892820,874820,OK
757.016691,delay,Tick,2022,1932,90,-90,140200,140800,24080,892820,874820,OK
757.229236,delay,Tick,2022,1932,90,-90,140200,140800,24080,892820,874820,OK
757.514576,delay,Tick,2022,1932,90,-90,140300,140800,24080,892820,874820,OK
757.73957,delay,Tick,2022,1932,90,-90,140300,140800,24080,892820,874820,OK
757.969529,delay,Tick,2022,1932,90,-90,140300,140800,24080,892820,874820,OK
758.258016,delay,Tick,2022,1932,90,-90,140300,140800,24080,892820,874820,OK
758.527205,delay,Tick,2022,1932,90,-90,140300,140800,24080,892820,874820,OK
758.741458,delay,Tick,2022,1932,90,-90,140300,140800,24080,892820,874820,OK
759.026473,delay,Tick,2022,1932,90,-90,140300,140800,24080,892820,874820,OK
759.290795,delay,Tick,2022,1932,90,-90,140600,141000,24080,892820,874820,OK
759.550948,delay,Tick,2022,1932,90,-90,140700,141000,24080,892820,874820,OK
759.732792,delay,Tick,2022,1932,90,-90,140700,141000,24080,892820,874820,OK
759.970872,delay,Tick,2022,1932,90,-90,140800,141000,24080,892820,874820,OK
760.23426,delay,Tick,2022,1932,90,-90,140800,141300,24080,892820,874820,OK
760.530982,delay,Tick,2022,1932,90,-90,140800,141300,24080,892820,874820,OK
760.801884,delay,Tick,2022,1932,90,-90,140800,141300,24080,892820,874820,OK
761.002251,delay,Tick,2022,1932,90,-90,140900,141300,24080,892820,874820,OK
761.276131,delay,Tick,2022,1932,90,-90,140800,141400,24080,892820,874820,OK
761.480838,delay,Tick,2022,1932,90,-90,140800,141400,24080,892820,874820,OK
761.767109,delay,Tick,2022,1932,90,-90,140800,141400,24080,892820,874820,OK
761.981004,delay,Tick,2022,1932,90,-90,140800,141400,24080,892820,874820,OK
762.251611,delay,Tick,2022,1932,90,-90,140800,141300,24080,892820,874820,OK
762.478506,delay,Tick,2022,1932,90,-90,140800,141300,24080,892820,874820,OK
762.736204,delay,Tick,2022,1932,90,-90,140800,141300,24080,892820,874820,OK
763.037488,delay,Tick,2022,1932,90,-90,140800,141300,24080,892820,874820,OK
763.260001,delay,Tick,2022,1932,90,-90,140800,141300,24080,892820,874820,OK
763.455537,delay,Tick,2022,1932,90,-90,140800,141300,24080,892820,874820,OK
763.776993,delay,Tick,2022,1932,90,-90,140800,141300,24080,892820,874820,OK
764.005404,delay,Tick,2022,1932,90,-90,140800,141300,24080,892820,874820,OK
764.260442,delay,Tick,2022,1932,90,-90,140900,141300,24080,892820,874820,OK
764.48545,delay,Tick,2022,1932,90,-90,140900,141300,24080,892820,874820,OK
764.730777,delay,Tick,2022,1932,90,-90,140900,141300,24080,892820,874820,OK
765.001509,delay,Tick,2022,1932,90,-90,140900,141300,24080,892820,874820,OK
765.214002,delay,Tick,2022,1932,90,-90,140900,141400,24080,892820,874820,OK
765.542513,delay,Tick,2022,1932,90,-90,141000,141400,24080,892820,874820,OK
765.702058,delay,Tick,2022,1932,90,-90,141000,141400,24080,892820,874820,OK
766.001304,delay,Tick,2022,1932,90,-90,141000,141400,24080,892820,874820,OK
766.292762,delay,Tick,2022,1932,90,-90,141000,141400,24080,892820,874820,OK
766.497637,delay,Tick,2022,1932,90,-90,141000,141400,24080,892820,874820,OK
766.710684,delay,Tick,2022,1932,90,-90,141000,141400,24080,892820,874820,OK
767.00198,delay,Tick,2022,1932,90,-90,140800,141400,24080,892820,874820,OK
767.245501,delay,Tick,2022,1932,90,-90,140800,141400,24080,892820,874820,OK
767.525714,delay,Tick,2022,1932,90,-90,141000,141400,24080,892820,874820,OK
767.75963,delay,Tick,2022,1932,90,-90,141000,141400,24080,892820,874820,OK
767.997649,delay,Tick,2022,1932,90,-90,141000,141400,24080,892820,874820,OK
768.21656,delay,Tick,2022,1932,90,-90,141000,141500,24080,892820,874820,OK
768.529375,delay,Tick,2022,1932,90,-90,141000,141500,24080,892820,874820,OK
768.786229,delay,Tick,2022,1932,90,-90,141000,141500,24080,892820,874820,OK
769.005706,delay,Tick,2022,1932,90,-90,141000,141500,24080,892820,874820,OK
769.24895,delay,Tick,2022,1932,90,-90,141000,141500,24080,892820,874820,OK
769.454643,delay,Tick,2022,1932,90,-90,141000,141500,24080,892820,874820,OK
769.705872,delay,Tick,2022,1932,90,-90,141000,141500,24080,892820,874820,OK
770.010976,delay,Tick,2022,1932,90,-90,141000,141500,24080,892820,874820,OK
770.294458,delay,Tick,2022,1932,90,-90,141100,141500,24080,892820,874820,OK
770.477414,delay,Tick,2022,1932,90,-90,140800,141500,24080,892820,874820,OK
770.752671,delay,Tick,2022,1932,90,-90,140800,141500,24080,892820,874820,OK
771.005084,delay,Tick,2022,1932,90,-90,140800,141500,24080,892820,874820,OK
771.267707,delay,Tick,2022,1932,90,-90,140800,141500,24080,892820,874820,OK
771.473659,delay,Tick,2022,1932,90,-90,140800,141500,24080,892820,874820,OK
771.800162,delay,Tick,2022,1932,90,-90,140800,141500,24080,892820,874820,OK
771.977705,delay,Tick,2022,1932,90,-90,140800,141500,24080,892820,874820,OK
772.244637,delay,Tick,2022,1932,90,-90,140800,141500,24080,892820,874820,OK
772.539262,delay,Tick,2022,1932,90,-90,141200,141500,24080,892820,874820,OK
772.793495,delay,Tick,2022,1932,90,-90,141200,141500,24080,892820,874820,OK
772.991195,delay,Tick,2022,1932,90,-90,141200,141500,24080,892820,874820,OK
773.222754,delay,Tick,2022,1932,90,-90,141200,141500,24080,892820,874820,OK
773.540612,delay,Tick,2022,1932,90,-90,141200,141500,24080,892820,874820,OK
773.725934,delay,Tick,2022,1932,90,-90,141200,141500,24080,892820,874820,OK
774.027965,delay,Tick,2022,1932,90,-90,140800,141400,24080,892820,874820,OK
774.238809,delay,Tick,2022,1932,90,-90,141200,141400,24080,892820,874820,OK
774.462604,delay,Tick,2022,1932,90,-90,141200,141400,24080,892820,874820,OK
774.70519,delay,Tick,2022,1932,90,-90,141200,141400,24080,892820,874820,OK
774.994623,delay,Tick,2022,1932,90,-90,141200,141500,24080,892820,874820,OK
775.280015,delay,Tick,2022,1932,90,-90,141200,141600,24080,892820,874820,OK
775.540451,delay,Tick,2022,1932,90,-90,141200,141600,24080,892820,874820,OK
775.779807,delay,Tick,2022,1932,90,-90,141200,141600,24080,892820,874820,OK
776.000339,delay,Tick,2022,1932,90,-90,141200,141600,24080,892820,874820,OK
776.225969,delay,Tick,2022,1932,90,-90,141200,141600,24080,892820,874820,OK
776.52333,delay,Tick,2022,1932,90,-90,141200,141600,24080,892820,874820,OK
776.79973,delay,Tick,2022,1932,90,-90,141100,141600,24080,892820,874820,OK
777.049459,delay,Tick,2022,1932,90,-90,141100,141600,24080,892820,874820,OK
777.260447,delay,Tick,2022,1932,90,-90,141100,141600,24080,892820,874820,OK
777.46128,delay,Tick,2022,1932,90,-90,141100,141600,24080,892820,874820,OK
777.733897,delay,Tick,2022,1932,90,-90,141100,141600,24080,892820,874820,OK
777.995813,delay,Tick,2022,1932,90,-90,141100,141600,24080,892820,874820,OK
778.29481,delay,Tick,2022,1932,90,-90,141100,141600,24080,892820,874820,OK
778.496332,delay,Tick,2022,1932,90,-90,141100,141700,24080,892820,874820,OK
778.726339,delay,Tick,2022,1932,90,-90,141200,141700,24080,892820,874820,OK
779.002063,delay,Tick,2022,1932,90,-90,141200,141800,24080,892820,874820,OK
779.281086,delay,Tick,2022,1932,90,-90,141200,141800,24080,892820,874820,OK
779.457384,delay,Tick,2022,1932,90,-90,141200,141800,24080,892820,874820,OK
779.770429,delay,Tick,2022,1932,90,-90,141200,141800,24080,892820,874820,OK
780.029825,delay,Tick,2022,1932,90,-90,141200,141800,24080,892820,874820,OK
780.274006,delay,Tick,2022,1932,90,-90,141200,141800,24080,892820,874820,OK
780.526906,delay,Tick,2022,1932,90,-90,141200,141800,24080,892820,874820,OK
780.761529,delay,Tick,2022,1932,90,-90,141200,141700,24080,892820,874820,OK
780.954617,delay,Tick,2022,1932,90,-90,141200,141700,24080,892820,874820,OK
781.267273,delay,Tick,2022,1932,90,-90,141300,141700,24080,892820,874820,OK
781.526638,delay,Tick,2022,1932,90,-90,141300,141700,24080,892820,874820,OK
781.743856,delay,Tick,2022,1932,90,-90,141300,141700,24080,892820,874820,OK
782.024099,delay,Tick,2022,1932,90,-90,141600,142100,24080,892820,874820,OK
782.215834,delay,Tick,2022,1932,90,-90,141700,142200,24080,892820,874820,OK
782.48629,delay,Tick,2022,1932,90,-90,141700,142200,24080,892820,874820,OK
782.761673,delay,Tick,2022,1932,90,-90,141700,142200,24080,892820,874820,OK
783.002647,delay,Tick,2022,1932,90,-90,141700,142200,24080,892820,874820,OK
783.263755,delay,Tick,2022,1932,90,-90,141800,142300,24080,892820,874820,OK
783.545561,delay,Tick,2022,1932,90,-90,141800,142300,24080,892820,874820,OK
783.793815,delay,Tick,2022,1932,90,-90,141800,142600,24080,892820,874820,OK
783.956799,delay,Tick,2022,1932,90,-90,142000,142600,24080,892820,874820,OK
784.218227,delay,Tick,2022,1932,90,-90,142200,142700,24080,892820,874820,OK
784.46737,delay,Tick,2022,1932,90,-90,142200,142800,24080,892820,874820,OK
784.764084,delay,Tick,2022,1932,90,-90,142200,142700,24080,892820,874820,OK
784.966799,delay,Tick,2022,1932,90,-90,142300,142700,24080,892820,874820,OK
785.273364,delay,Tick,2022,1932,90,-90,142300,142700,24080,892820,874820,OK
785.509377,delay,Tick,2022,1932,90,-90,142300,142700,24080,892820,874820,OK
785.719864,delay,Tick,2022,1932,90,-90,142300,142700,24080,892820,874820,OK
785.982261,delay,Tick,2022,1932,90,-90,142300,142700,24080,892820,874820,OK
786.2124,delay,Tick,2022,1932,90,-90,142300,142800,24080,892820,874820,OK
786.467047,delay,Tick,2022,1932,90,-90,142300,142800,24080,892820,874820,OK
786.720206,delay,Tick,2022,1932,90,-90,142300,142800,24080,892820,874820,OK
786.959675,delay,Tick,2022,1932,90,-90,142300,142800,24080,892820,874820,OK
787.265993,delay,Tick,2022,1932,90,-90,142300,142800,24080,892820,874820,OK
787.485672,delay,Tick,2022,1932,90,-90,142100,142800,24080,892820,874820,OK
787.769986,delay,Tick,2022,1932,90,-90,142100,142800,24080,892820,874820,OK
788.009617,delay,Tick,2022,1932,90,-90,142100,142600,24080,892820,874820,OK
788.296239,delay,Tick,2022,1932,90,-90,142100,142600,24080,892820,874820,OK
788.494492,delay,Tick,2022,1932,90,-90,142000,142600,24080,892820,874820,OK
788.742037,delay,Tick,2022,1932,90,-90,142000,142700,24080,892820,874820,OK
788.962878,delay,Tick,2022,1932,90,-90,142000,142700,24080,892820,874820,OK
789.28623,delay,Tick,2022,1932,90,-90,142000,142700,24080,892820,874820,OK
789.524965,delay,Tick,2022,1932,90,-90,142400,142700,24080,892820,874820,OK
789.797182,delay,Tick,2022,1932,90,-90,142400,142700,24080,892820,874820,OK
790.026799,delay,Tick,2022,1932,90,-90,142300,142700,24080,892820,874820,OK
790.231673,delay,Tick,2022,1932,90,-90,142300,142700,24080,892820,874820,OK
790.488841,delay,Tick,2022,1932,90,-90,142300,142700,24080,892820,874820,OK
790.764497,delay,Tick,2022,1932,90,-90,142300,142700,24080,892820,874820,OK
791.021492,delay,Tick,2022,1932,90,-90,142000,142700,24080,892820,874820,OK
791.20875,delay,Tick,2022,1932,90,-90,142000,142700,24080,892820,874820,OK
791.495315,delay,Tick,2022,1932,90,-90,142000,142700,24080,892820,874820,OK
791.752798,delay,Tick,2022,1932,90,-90,142000,142700,24080,892820,874820,OK
792.015648,delay,Tick,2022,1932,90,-90,142000,142700,24080,892820,874820,OK
792.221692,delay,Tick,2022,1932,90,-90,142000,142700,24080,892820,874820,OK
792.548636,delay,Tick,2022,1932,90,-90,142000,142700,24080,892820,874820,OK
792.770149,delay,Tick,2022,1932,90,-90,142000,142700,24080,892820,874820,OK
792.971137,delay,Tick,2022,1932,90,-90,142000,142700,24080,892820,874820,OK
793.203368,delay,Tick,2022,1932,90,-90,142000,142700,24080,892820,874820,OK
793.451672,delay,Tick,2022,1932,90,-90,142000,142700,24080,892820,874820,OK
793.750473,delay,Tick,2022,1932,90,-90,142400,142700,24080,892820,874820,OK
794.042681,delay,Tick,2022,1932,90,-90,142400,142700,24080,892820,874820,OK
794.227205,delay,Tick,2022,1932,90,-90,142400,142700,24080,892820,874820,OK
794.544846,delay,Tick,2022,1932,90,-90,142500,142700,24080,892820,874820,OK
794.76689,delay,Tick,2022,1932,90,-90,142500,142700,24080,892820,874820,OK
794.964028,delay,Tick,2022,1932,90,-90,142500,142700,24080,892820,874820,OK
795.207036,delay,Tick,2022,1932,90,-90,142200,142700,24080,892820,874820,OK
795.51373,delay,Tick,2022,1932,90,-90,142200,142700,24080,892820,874820,OK
795.771687,delay,Tick,2022,1932,90,-90,142200,142700,24080,892820,874820,OK
795.963337,delay,Tick,2022,1932,90,-90,142200,142700,24080,892820,874820,OK
796.271396,delay,Tick,2022,1932,90,-90,142200,142700,24080,892820,874820,OK
796.546891,delay,Tick,2022,1932,90,-90,142200,142700,24080,892820,874820,OK
796.759348,delay,Tick,2022,1932,90,-90,142300,142700,24080,892820,874820,OK
796.963605,delay,Tick,2022,1932,90,-90,142300,142900,24080,892820,874820,OK
797.288088,delay,Tick,2022,1932,90,-90,142300,142900,24080,892820,874820,OK
797.499138,delay,Tick,2022,1932,90,-90,142300,142900,24080,892820,874820,OK
797.757899,delay,Tick,2022,1932,90,-90,142300,142900,24080,892820,874820,OK
797.987419,delay,Tick,2022,1932,90,-90,142300,142900,24080,892820,874820,OK
798.245979,delay,Tick,2022,1932,90,-90,142500,142900,24080,892820,874820,OK
798.45103,delay,Tick,2022,1932,90,-90,142400,142900,24080,892820,874820,OK
798.766965,delay,Tick,2022,1932,90,-90,142400,142900,24080,892820,874820,OK
799.016867,delay,Tick,2022,1932,90,-90,142400,142900,24080,892820,874820,OK
799.255419,delay,Tick,2022,1932,90,-90,142600,143200,24080,892820,874820,OK
799.538387,delay,Tick,2022,1932,90,-90,142800,143100,24080,892820,874820,OK
799.730651,delay,Tick,2022,1932,90,-90,142800,143100,24080,892820,874820,OK
800.038031,delay,Tick,2022,1932,90,-90,142800,143100,24080,892820,874820,OK
800.290185,delay,Tick,2022,1932,90,-90,142600,143100,24080,892820,874820,OK
800.550206,delay,Tick,2022,1932,90,-90,142600,143100,24080,892820,874820,OK
800.790386,delay,Tick,2022,1932,90,-90,142600,143000,24080,892820,874820,OK
801.044833,delay,Tick,2022,1932,90,-90,142600,143000,24080,892820,874820,OK
801.238644,delay,Tick,2022,1932,90,-90,142600,143000,24080,892820,874820,OK
801.546128,delay,Tick,2022,1932,90,-90,142600,143000,24080,892820,874820,OK
801.718742,delay,Tick,2022,1932,90,-90,142600,143000,24080,892820,874820,OK
802.012492,delay,Tick,2022,1932,90,-90,142600,143000,24080,892820,874820,OK
802.214763,delay,Tick,2022,1932,90,-90,142600,143000,24080,892820,874820,OK
802.537135,delay,Tick,2022,1932,90,-90,142600,143000,24080,892820,874820,OK
802.753715,delay,Tick,2022,1932,90,-90,142400,143000,24080,892820,874820,OK
802.964974,delay,Tick,2022,1932,90,-90,142400,143000,24080,892820,874820,OK
803.25551,delay,Tick,2022,1932,90,-90,142400,143000,24080,892820,874820,OK
803.511778,delay,Tick,2022,1932,90,-90,142400,143000,24080,892820,874820,OK
803.712817,delay,Tick,2022,1932,90,-90,142400,143100,24080,892820,874820,OK
804.042403,delay,Tick,2022,1932,90,-90,142400,143300,24080,892820,874820,OK
804.252826,delay,Tick,2022,1932,90,-90,142900,143400,24080,892820,874820,OK
804.509795,delay,Tick,2022,1932,90,-90,142900,143400,24080,892820,874820,OK
804.768759,delay,Tick,2022,1932,90,-90,142900,143400,24080,892820,874820,OK
804.995435,delay,Tick,2022,1932,90,-90,142900,143400,24080,892820,874820,OK
805.236322,delay,Tick,2022,1932,90,-90,142800,143400,24080,892820,874820,OK
805.551369,delay,Tick,2022,1932,90,-90,142800,143300,24080,892820,874820,OK
805.722068,delay,Tick,2022,1932,90,-90,143000,143300,24080,892820,874820,OK
805.993295,delay,Tick,2022,1932,90,-90,143000,143300,24080,892820,874820,OK
806.2822,delay,Tick,2022,1932,90,-90,143000,143300,24080,892820,874820,OK
806.53494,delay,Tick,2022,1932,90,-90,143000,143300,24080,892820,874820,OK
806.757429,delay,Tick,2022,1932,90,-90,143000,143300,24080,892820,874820,OK
807.047607,delay,Tick,2022,1932,90,-90,143000,143300,24080,892820,874820,OK
807.200916,delay,Tick,2022,1932,90,-90,143000,143300,24080,892820,874820,OK
807.516767,delay,Tick,2022,1932,90,-90,143000,143300,24080,892820,874820,OK
807.737183,delay,Tick,2022,1932,90,-90,143000,143300,24080,892820,874820,OK
807.996027,delay,Tick,2022,1932,90,-90,142600,143300,24080,892820,874820,OK
808.249767,delay,Tick,2022,1932,90,-90,142600,143300,24080,892820,874820,OK
808.546804,delay,Tick,2022,1932,90,-90,142800,143400,24080,892820,874820,OK
808.741596,delay,Tick,2022,1932,90,-90,142800,143400,24080,892820,874820,OK
809.021465,delay,Tick,2022,1932,90,-90,142800,143200,24080,892820,874820,OK
809.243522,delay,Tick,2022,1932,90,-90,143000,143200,24080,892820,874820,OK
809.528955,delay,Tick,2022,1932,90,-90,143000,143200,24080,892820,874820,OK
809.729932,delay,Tick,2022,1932,90,-90,143000,143200,24080,892820,874820,OK
810.017607,delay,Tick,2022,1932,90,-90,143000,143200,24080,892820,874820,OK
810.252184,delay,Tick,2022,1932,90,-90,143000,143200,24080,892820,874820,OK
810.469935,delay,Tick,2022,1932,90,-90,143000,143200,24080,892820,874820,OK
810.737837,delay,Tick,2022,1932,90,-90,143000,143200,24080,892820,874820,OK
810.968723,delay,Tick,2022,1932,90,-90,143000,143200,24080,892820,874820,OK
811.263715,delay,Tick,2022,1932,90,-90,143000,143000,24080,892820,892820,OK
811.454704,delay,Tick,2022,1932,90,-90,142400,143000,24080,892820,874820,OK
811.768933,delay,Tick,2022,1932,90,-90,142400,142900,24080,892820,874820,OK
811.975839,delay,Tick,2022,1932,90,-90,142400,142900,24080,892820,874820,OK
812.249944,delay,Tick,2022,1932,90,-90,143100,142900,24080,892820,910820,OK
812.532629,delay,Tick,2022,1932,90,-90,143100,142900,24080,892820,910820,OK
812.707857,delay,Tick,2022,1932,90,-90,143100,142900,24080,892820,910820,OK
812.977434,delay,Tick,2022,1932,90,-90,142300,142900,24080,892820,874820,OK
813.214258,delay,Tick,2022,1932,90,-90,142300,142900,24080,892820,874820,OK
813.466756,delay,Tick,2022,1932,90,-90,142300,142800,24080,892820,874820,OK
813.761146,delay,Tick,2022,1932,90,-90,142300,142800,24080,892820,874820,OK
814.037265,delay,Tick,2022,1932,90,-90,142300,142800,24080,892820,874820,OK
814.224094,delay,Tick,2022,1932,90,-90,142300,142800,24080,892820,874820,OK
814.520246,delay,Tick,2022,1932,90,-90,142300,142800,24080,892820,874820,OK
814.734964,delay,Tick,2022,1932,90,-90,142300,142800,24080,892820,874820,OK
814.993509,delay,Tick,2022,1932,90,-90,143100,142800,24080,892820,910820,OK
815.223342,delay,Tick,2022,1932,90,-90,143100,142800,24080,892820,910820,OK
815.477587,delay,Tick,2022,1932,90,-90,143100,142800,24080,892820,910820,OK
815.757303,delay,Tick,2022,1932,90,-90,143100,142800,24080,892820,910820,OK
816.047207,delay,Tick,2022,1932,90,-90,143100,142800,24080,892820,910820,OK
816.211649,delay,Tick,2022,1932,90,-90,143100,142800,24080,892820,910820,OK
816.498146,delay,Tick,2022,1932,90,-90,143100,142800,24080,892820,910820,OK
816.717972,delay,Tick,2022,1932,90,-90,143100,142800,24080,892820,910820,OK
817.004085,delay,Tick,2022,1932,90,-90,143100,142800,24080,892820,910820,OK
817.299511,delay,Tick,2022,1932,90,-90,143100,142800,24080,892820,910820,OK
817.497821,delay,Tick,2022,1932,90,-90,142900,142800,24080,892820,901820,OK
817.755482,delay,Tick,2022,1932,90,-90,142900,142800,24080,892820,901820,OK
818.015919,delay,Tick,2022,1932,90,-90,142900,142800,24080,892820,901820,OK
818.275615,delay,Tick,2022,1932,90,-90,142900,142800,24080,892820,901820,OK
818.461393,delay,Tick,2022,1932,90,-90,142900,142800,24080,892820,901820,OK
818.747488,delay,Tick,2022,1932,90,-90,142900,142800,24080,892820,901820,OK
819.012617,delay,Tick,2022,1932,90,-90,142400,143000,24080,892820,874820,OK
819.289026,delay,Tick,2022,1932,90,-90,142800,142800,24080,892820,892820,OK
819.513558,delay,Tick,2022,1932,90,-90,142800,142800,24080,892820,892820,OK
819.710732,delay,Tick,2022,1932,90,-90,142800,142800,24080,892820,892820,OK
820.047403,delay,Tick,2022,1932,90,-90,142800,142800,24080,892820,892820,OK
820.293365,delay,Tick,2022,1932,90,-90,142800,142800,24080,892820,892820,OK
820.457834,delay,Tick,2022,1932,90,-90,142800,142800,24080,892820,892820,OK
820.708529,delay,Tick,2022,1932,90,-90,142800,142800,24080,892820,892820,OK
820.985603,delay,Tick,2022,1932,90,-90,142800,142900,24080,892820,883820,OK
821.215489,delay,Tick,2022,1932,90,-90,142800,142900,24080,892820,883820,OK
821.501486,delay,Tick,2022,1932,90,-90,142800,142900,24080,892820,883820,OK
821.733486,delay,Tick,2022,1932,90,-90,142800,142800,24080,892820,892820,OK
822.028281,delay,Tick,2022,1932,90,-90,142200,142800,24080,892820,874820,OK
822.212584,delay,Tick,2022,1932,90,-90,142200,142800,24080,892820,874820,OK
822.533141,delay,Tick,2022,1932,90,-90,142200,142800,24080,892820,874820,OK
822.776617,delay,Tick,2022,1932,90,-90,142200,142800,24080,892820,874820,OK
822.994939,delay,Tick,2022,1932,90,-90,142200,142800,24080,892820,874820,OK
823.289578,delay,Tick,2022,1932,90,-90,142200,142800,24080,892820,874820,OK
823.466827,delay,Tick,2022,1932,90,-90,142200,142800,24080,892820,874820,OK
823.73206,delay,Tick,2022,1932,90,-90,142400,142800,24080,892820,874820,OK
823.965573,delay,Tick,2022,1932,90,-90,142400,142800,24080,892820,874820,OK
824.207469,delay,Tick,2022,1932,90,-90,142400,142800,24080,892820,874820,OK
824.494065,delay,Tick,2022,1932,90,-90,142400,142800,24080,892820,874820,OK
824.738915,delay,Tick,2022,1932,90,-90,142400,142800,24080,892820,874820,OK
824.984087,delay,Tick,2022,1932,90,-90,142200,142800,24080,892820,874820,OK
825.234656,delay,Tick,2022,1932,90,-90,142200,142800,24080,892820,874820,OK
825.515271,delay,Tick,2022,1932,90,-90,142200,142800,24080,892820,874820,OK
825.788052,delay,Tick,2022,1932,90,-90,142200,142800,24080,892820,874820,OK
825.980655,delay,Tick,2022,1932,90,-90,142200,142800,24080,892820,874820,OK
826.248759,delay,Tick,2022,1932,90,-90,142200,142800,24080,892820,874820,OK
826.488077,delay,Tick,2022,1932,90,-90,142200,142800,24080,892820,874820,OK
826.792079,delay,Tick,2022,1932,90,-90,142200,142800,24080,892820,874820,OK
826.986147,delay,Tick,2022,1932,90,-90,142200,142800,24080,892820,874820,OK
827.219047,delay,Tick,2022,1932,90,-90,142200,142800,24080,892820,874820,OK
827.524347,delay,Tick,2022,1946,76,-76,142900,142800,23880,893020,900620,OK
827.776129,delay,Tick,2022,1946,76,-76,142900,142800,23880,893020,900620,OK
828.049161,delay,Tick,2022,1946,76,-76,142900,142800,23880,893020,900620,OK
828.203645,delay,Tick,2022,1946,76,-76,142900,142800,23880,893020,900620,OK
828.474333,delay,Tick,2022,1946,76,-76,142900,142700,23880,893020,908220,OK
828.775447,delay,Tick,2022,1946,76,-76,142900,142700,23880,893020,908220,OK
828.964307,delay,Tick,2022,1946,76,-76,142900,142800,23880,893020,900620,OK
829.238041,delay,Tick,2022,1946,76,-76,142900,142800,23880,893020,900620,OK
829.515353,delay,Tick,2022,1946,76,-76,142900,142800,23880,893020,900620,OK
829.791454,delay,Tick,2022,1946,76,-76,142900,142800,23880,893020,900620,OK
830.030397,delay,Tick,2022,1946,76,-76,142900,142800,23880,893020,900620,OK
830.244992,delay,Tick,2022,1946,76,-76,142900,142800,23880,893020,900620,OK
830.502207,delay,Tick,2022,1946,76,-76,143000,142800,23880,893020,908220,OK
830.767243,delay,Tick,2022,1946,76,-76,143100,142800,23880,893020,908220,OK
830.962006,delay,Tick,2022,1946,76,-76,143100,142800,23880,893020,908220,OK
831.271839,delay,Tick,2022,1946,76,-76,143100,142800,23880,893020,908220,OK
831.533716,delay,Tick,2022,1946,76,-76,143100,142800,23880,893020,908220,OK
831.768067,delay,Tick,2022,1946,76,-76,143100,142800,23880,893020,908220,OK
831.958935,delay,Tick,2022,1946,76,-76,143100,142800,23880,893020,908220,OK
832.229295,delay,Tick,2022,1946,76,-76,143100,142900,23880,893020,908220,OK
832.46426,delay,Tick,2022,1946,76,-76,143100,142900,23880,893020,908220,OK
832.734032,delay,Tick,2022,1946,76,-76,143100,142900,23880,893020,908220,OK
833.032239,delay,Tick,2022,1946,76,-76,143100,142900,23880,893020,908220,OK
833.217856,delay,Tick,2022,1946,76,-76,143100,142900,23880,893020,908220,OK
833.492797,delay,Tick,2022,1946,76,-76,143100,142900,23880,893020,908220,OK
833.715941,delay,Tick,2022,1946,76,-76,143100,142900,23880,893020,908220,OK
834.032452,delay,Tick,2032,1946,86,-86,142300,143000,23737,898163,880963,OK
834.226075,delay,Tick,2032,1946,86,-86,142300,143400,23737,898163,880963,OK
834.548889,delay,Tick,2036,1946,90,-90,143100,143400,23851,898849,880849,OK
834.772483,delay,Tick,2036,1946,90,-90,143200,143400,23851,898849,880849,OK
835.042974,delay,Tick,2036,1946,90,-90,143200,143400,23851,898849,880849,OK
835.283521,delay,Tick,2036,1946,90,-90,143200,143400,23851,898849,880849,OK
835.476151,delay,Tick,2036,1946,90,-90,143200,143300,23851,898849,889849,OK
835.72473,delay,Tick,2036,1946,90,-90,142800,143300,23851,898849,880849,OK
835.951387,delay,Tick,2036,1946,90,-90,142800,143300,23851,898849,880849,OK
836.264623,delay,Tick,2036,1946,90,-90,143300,143300,23851,898849,898849,OK
836.477412,delay,Tick,2036,1946,90,-90,143300,143300,23851,898849,898849,OK
836.791915,delay,Tick,2036,1946,90,-90,143300,143300,23851,898849,898849,OK
837.01744,delay,Tick,2036,1946,90,-90,143300,143300,23851,898849,898849,OK
837.267817,delay,Tick,2036,2016,20,-20,143200,143000,22849,906851,910851,OK
837.532866,delay,Tick,2036,2016,20,-20,143200,142900,22849,906851,910851,OK
837.775118,delay,Tick,2036,2016,20,-20,143200,142900,22849,906851,910851,OK
837.991604,delay,Tick,2036,2016,20,-20,143200,142900,22849,906851,910851,OK
838.269228,delay,Tick,2036,2016,20,-20,143200,142900,22849,906851,910851,OK
838.488858,delay,Tick,2036,2016,20,-20,143200,142900,22849,906851,910851,OK
838.77323,delay,Tick,2036,2016,20,-20,143200,142900,22849,906851,910851,OK
838.967211,delay,Tick,2036,2016,20,-20,143200,142900,22849,906851,910851,OK
839.213228,delay,Tick,2036,2016,20,-20,143200,142900,22849,906851,910851,OK
839.509024,delay,Tick,2036,2016,20,-20,143200,142900,22849,906851,910851,OK
839.718963,delay,Tick,2036,2016,20,-20,143200,143000,22849,906851,910851,OK
839.971066,delay,Tick,2046,2016,30,-30,142700,143000,23134,908566,902566,OK
840.232,delay,Tick,2056,2016,40,-40,142700,143000,23419,910281,902281,OK
840.527231,delay,Tick,2066,2016,50,-50,142700,143000,23704,912996,902996,OK
840.799057,delay,Tick,2076,2016,60,-60,142700,143000,23989,915711,903711,OK
840.976957,delay,Tick,2086,2016,70,-70,142700,143000,24274,919426,905426,OK
841.23335,delay,Tick,2096,2016,80,-80,142700,143000,24559,923141,907141,OK
841.499711,delay,Tick,2106,2016,90,-90,142700,143000,24844,925856,907856,OK
841.784968,delay,Tick,2106,2016,90,-90,142700,143000,24844,925856,907856,OK
841.987712,delay,Tick,2106,2016,90,-90,142700,143000,24844,925856,907856,OK
842.210519,delay,Tick,2106,2016,90,-90,142700,143000,24844,925856,907856,OK
842.482766,delay,Tick,2106,2016,90,-90,142400,143000,24844,925856,907856,OK
842.721156,delay,Tick,2106,2016,90,-90,142600,143000,24844,925856,907856,OK
843.025369,delay,Tick,2106,2016,90,-90,142600,143000,24844,925856,907856,OK
843.263465,delay,Tick,2106,2016,90,-90,142400,142600,24844,925856,907856,OK
843.495913,delay,Tick,2106,2016,90,-90,142400,142600,24844,925856,907856,OK
843.791479,delay,Tick,2106,2016,90,-90,142400,142600,24844,925856,907856,OK
843.998079,delay,Tick,2106,2016,90,-90,142400,142600,24844,925856,907856,OK
844.233859,delay,Tick,2106,2016,90,-90,142400,142600,24844,925856,907856,OK
844.47929,delay,Tick,2106,2016,90,-90,142400,142600,24844,925856,907856,OK
844.777565,delay,Tick,2106,2016,90,-90,142400,142600,24844,925856,907856,OK
844.96992,delay,Tick,2106,2016,90,-90,142600,142600,24844,925856,925856,OK
845.215081,delay,Tick,2106,2029,77,-77,143000,142600,24658,927342,942742,OK
845.473979,delay,Tick,2106,2029,77,-77,143000,142600,24658,927342,942742,OK
845.747747,delay,Tick,2106,2029,77,-77,143000,142600,24658,927342,942742,OK
846.029084,delay,Tick,2116,2029,87,-87,142900,142600,24516,929484,946884,OK
846.227096,delay,Tick,2116,2029,87,-87,142900,142600,24516,929484,946884,OK
846.46807,delay,Tick,2116,2029,87,-87,142900,142600,24516,929484,946884,OK
846.781253,delay,Tick,2116,2029,87,-87,142900,142600,24516,929484,946884,OK
846.956626,delay,Tick,2116,2029,87,-87,142900,142600,24516,929484,946884,OK
847.253092,delay,Tick,2116,2029,87,-87,142900,142600,24516,929484,946884,OK
847.509905,delay,Tick,2116,2029,87,-87,142900,142600,24516,929484,946884,OK
847.778338,delay,Tick,2116,2036,80,-80,143100,142600,24416,930984,946984,OK
848.027622,delay,Tick,2116,2036,80,-80,143100,142600,24416,930984,946984,OK
848.263396,delay,Tick,2116,2036,80,-80,143100,142600,24416,930984,946984,OK
848.525108,delay,Tick,2116,2036,80,-80,143100,142600,24416,930984,946984,OK
848.738087,delay,Tick,2116,2036,80,-80,143100,142600,24416,930984,946984,OK
848.985,delay,Tick,2116,2094,22,-22,143100,142600,23586,943414,947814,OK
849.233946,delay,Tick,2117,2094,23,-23,142600,142600,23572,943728,943728,OK
849.512251,delay,Tick,2117,2094,23,-23,142600,142900,23572,943728,939128,OK
849.755928,delay,Tick,2117,2094,23,-23,142600,142900,23572,943728,939128,OK
849.960831,delay,Tick,2117,2094,23,-23,142600,142900,23572,943728,939128,OK
850.265423,delay,Tick,2117,2094,23,-23,142600,143000,23572,943728,939128,OK
850.522517,delay,Tick,2117,2094,23,-23,142600,143000,23572,943728,939128,OK
850.726278,delay,Tick,2117,2094,23,-23,142600,143000,23572,943728,939128,OK
851.031447,delay,Tick,2117,2094,23,-23,142600,143000,23572,943728,939128,OK
851.265634,delay,Tick,2117,2094,23,-23,143300,143000,23572,943728,948328,OK
851.512088,delay,Tick,2117,2094,23,-23,143300,143400,23572,943728,941428,OK
851.740115,delay,Tick,2117,2094,23,-23,143300,143400,23572,943728,941428,OK
851.953168,delay,Tick,2117,2094,23,-23,143300,143400,23572,943728,941428,OK
852.275544,delay,Tick,2117,2094,23,-23,143300,143400,23572,943728,941428,OK
852.476266,delay,Tick,2117,2094,23,-23,143300,143400,23572,943728,941428,OK
852.738115,delay,Tick,2117,2094,23,-23,143300,143400,23572,943728,941428,OK
853.043005,delay,Tick,2117,2094,23,-23,143300,143400,23572,943728,941428,OK
853.289013,delay,Tick,2117,2094,23,-23,143300,143400,23572,943728,941428,OK
853.484458,delay,Tick,2117,2094,23,-23,143300,143400,23572,943728,941428,OK
853.774788,delay,Tick,2117,2094,23,-23,143300,143400,23572,943728,941428,OK
853.972699,delay,Tick,2117,2094,23,-23,143300,143400,23572,943728,941428,OK
854.239648,delay,Tick,2117,2094,23,-23,143300,143500,23572,943728,939128,OK
854.496376,delay,Tick,2117,2094,23,-23,143300,143500,23572,943728,939128,OK
854.745287,delay,Tick,2117,2094,23,-23,143300,143500,23572,943728,939128,OK
855.012003,delay,Tick,2127,2094,33,-33,143300,143500,23859,945441,938841,OK
855.247371,delay,Tick,2137,2094,43,-43,143300,143800,24146,947154,938554,OK
855.5507,delay,Tick,2147,2094,53,-53,143400,143800,24433,950867,940267,OK
855.77972,delay,Tick,2157,2094,63,-63,143400,143800,24720,954580,941980,OK
855.989742,delay,Tick,2167,2094,73,-73,143400,143800,25007,957293,942693,OK
856.274269,delay,Tick,2177,2094,83,-83,143400,143800,25294,960006,943406,OK
856.460498,delay,Tick,2184,2094,90,-90,143400,143700,25495,961905,943905,OK
856.742657,delay,Tick,2184,2094,90,-90,143400,143700,25495,961905,943905,OK
857.029733,delay,Tick,2184,2094,90,-90,143400,143700,25495,961905,943905,OK
857.287157,delay,Tick,2184,2094,90,-90,143400,143700,25495,961905,943905,OK
857.505649,delay,Tick,2184,2094,90,-90,143400,143700,25495,961905,943905,OK
857.753763,delay,Tick,2184,2094,90,-90,143400,143700,25495,961905,943905,OK
858.022709,delay,Tick,2184,2094,90,-90,143400,143700,25495,961905,943905,OK
858.292536,delay,Tick,2184,2094,90,-90,143400,143700,25495,961905,943905,OK
858.530868,delay,Tick,2184,2094,90,-90,143400,143700,25495,961905,943905,OK
858.757993,delay,Tick,2184,2094,90,-90,143400,143700,25495,961905,943905,OK
859.012058,delay,Tick,2184,2094,90,-90,143400,143900,25495,961905,943905,OK
859.277249,delay,Tick,2184,2094,90,-90,143400,143900,25495,961905,943905,OK
859.453582,delay,Tick,2184,2094,90,-90,143400,144100,25495,961905,943905,OK
859.724074,delay,Tick,2184,2094,90,-90,143400,144100,25495,961905,943905,OK
860.04331,delay,Tick,2184,2094,90,-90,143400,144000,25495,961905,943905,OK
860.289496,delay,Tick,2184,2094,90,-90,143400,144000,25495,961905,943905,OK
860.464472,delay,Tick,2184,2094,90,-90,143400,144000,25495,961905,943905,OK
860.749932,delay,Tick,2184,2094,90,-90,143400,144000,25495,961905,943905,OK
860.992331,delay,Tick,2184,2094,90,-90,143500,144000,25495,961905,943905,OK
861.239421,delay,Tick,2184,2094,90,-90,143500,143900,25495,961905,943905,OK
861.460705,delay,Tick,2184,2094,90,-90,143500,143800,25495,961905,943905,OK
861.759396,delay,Tick,2184,2094,90,-90,143500,143800,25495,961905,943905,OK
862.038599,delay,Tick,2184,2094,90,-90,143000,143800,25495,961905,943905,OK
862.288195,delay,Tick,2184,2094,90,-90,143000,143800,25495,961905,943905,OK
862.543968,delay,Tick,2184,2094,90,-90,143100,143800,25495,961905,943905,OK
862.797072,delay,Tick,2184,2094,90,-90,143100,143800,25495,961905,943905,OK
863.03717,delay,Tick,2184,2094,90,-90,143100,143800,25495,961905,943905,OK
863.288256,delay,Tick,2184,2094,90,-90,143100,143800,25495,961905,943905,OK
863.53419,delay,Tick,2184,2094,90,-90,143100,143800,25495,961905,943905,OK
863.763685,delay,Tick,2184,2094,90,-90,143100,143800,25495,961905,943905,OK
863.965716,delay,Tick,2184,2094,90,-90,143100,143800,25495,961905,943905,OK
864.244525,delay,Tick,2184,2094,90,-90,143100,143500,25495,961905,943905,OK
864.478348,delay,Tick,2184,2094,90,-90,143100,143500,25495,961905,943905,OK
864.770764,delay,Tick,2184,2094,90,-90,143100,143500,25495,961905,943905,OK
865.012864,delay,Tick,2184,2094,90,-90,143100,143500,25495,961905,943905,OK
865.294768,delay,Tick,2184,2094,90,-90,143500,143500,25495,961905,961905,OK
865.54259,delay,Tick,2184,2094,90,-90,143500,143500,25495,961905,961905,OK
865.769436,delay,Tick,2184,2094,90,-90,143500,143500,25495,961905,961905,OK
866.015103,delay,Tick,2184,2094,90,-90,143500,143500,25495,961905,961905,OK
866.257172,delay,Tick,2184,2094,90,-90,143500,143600,25495,961905,952905,OK
866.497383,delay,Tick,2184,2094,90,-90,143500,143600,25495,961905,952905,OK
866.766907,delay,Tick,2184,2094,90,-90,143500,143600,25495,961905,952905,OK
867.04168,delay,Tick,2184,2094,90,-90,143500,143600,25495,961905,952905,OK
867.295191,delay,Tick,2184,2094,90,-90,143500,143600,25495,961905,952905,OK
867.517278,delay,Tick,2184,2094,90,-90,143500,143600,25495,961905,952905,OK
867.789384,delay,Tick,2184,2094,90,-90,143500,143600,25495,961905,952905,OK
868.045971,delay,Tick,2184,2094,90,-90,143500,143600,25495,961905,952905,OK
868.244102,delay,Tick,2184,2094,90,-90,143500,143600,25495,961905,952905,OK
868.493634,delay,Tick,2184,2094,90,-90,143500,143600,25495,961905,952905,OK
868.717591,delay,Tick,2184,2094,90,-90,143500,143600,25495,961905,952905,OK
868.959544,delay,Tick,2184,2094,90,-90,143500,143600,25495,961905,952905,OK
869.240377,delay,Tick,2184,2094,90,-90,143500,143600,25495,961905,952905,OK
869.499624,delay,Tick,2184,2094,90,-90,143500,143600,25495,961905,952905,OK
869.787911,delay,Tick,2184,2094,90,-90,143300,143600,25495,961905,943905,OK
869.996895,delay,Tick,2184,2094,90,-90,143300,143600,25495,961905,943905,OK
870.245375,delay,Tick,2184,2094,90,-90,143300,143600,25495,961905,943905,OK
870.548338,delay,Tick,2184,2094,90,-90,143300,143200,25495,961905,970905,OK
870.702345,delay,Tick,2184,2094,90,-90,143300,143200,25495,961905,970905,OK
871.043875,delay,Tick,2184,2094,90,-90,143300,143200,25495,961905,970905,OK
871.288916,delay,Tick,2184,2094,90,-90,143300,143200,25495,961905,970905,OK
871.498433,delay,Tick,2184,2094,90,-90,143300,143200,25495,961905,970905,OK
871.794062,delay,Tick,2184,2094,90,-90,143300,143200,25495,961905,970905,OK
872.005446,delay,Tick,2184,2094,90,-90,143300,143200,25495,961905,970905,OK
872.272265,delay,Tick,2184,2094,90,-90,143300,143200,25495,961905,970905,OK
872.486679,delay,Tick,2184,2094,90,-90,143600,143200,25495,961905,979905,OK
872.760771,delay,Tick,2184,2094,90,-90,143600,143200,25495,961905,979905,OK
872.962635,delay,Tick,2184,2094,90,-90,143600,143200,25495,961905,979905,OK
873.211493,delay,Tick,2184,2094,90,-90,143300,143200,25495,961905,970905,OK
873.519197,delay,Tick,2184,2094,90,-90,143300,143300,25495,961905,961905,OK
873.713808,delay,Tick,2184,2094,90,-90,143300,143400,25495,961905,952905,OK
873.999258,delay,Tick,2184,2094,90,-90,143300,143500,25495,961905,943905,OK
874.228219,delay,Tick,2184,2094,90,-90,143300,143500,25495,961905,943905,OK
874.539445,delay,Tick,2184,2094,90,-90,143300,143500,25495,961905,943905,OK
874.767543,delay,Tick,2184,2094,90,-90,143300,143500,25495,961905,943905,OK
874.951489,delay,Tick,2184,2094,90,-90,143300,143500,25495,961905,943905,OK
875.21282,delay,Tick,2184,2094,90,-90,143300,143500,25495,961905,943905,OK
875.508873,delay,Tick,2184,2094,90,-90,143600,143700,25495,961905,952905,OK
875.796391,delay,Tick,2184,2094,90,-90,143200,143700,25495,961905,943905,OK
876.047376,delay,Tick,2184,2094,90,-90,143200,143700,25495,961905,943905,OK
876.291411,delay,Tick,2184,2094,90,-90,143200,143700,25495,961905,943905,OK
876.505114,delay,Tick,2184,2094,90,-90,143200,143700,25495,961905,943905,OK
876.732893,delay,Tick,2184,2094,90,-90,143200,143700,25495,961905,943905,OK
877.015568,delay,Tick,2184,2094,90,-90,143200,143700,25495,961905,943905,OK
877.279959,delay,Tick,2184,2094,90,-90,143200,143700,25495,961905,943905,OK
877.497884,delay,Tick,2184,2094,90,-90,143400,143700,25495,961905,943905,OK
877.756173,delay,Tick,2184,2094,90,-90,143400,143700,25495,961905,943905,OK
877.99793,delay,Tick,2184,2094,90,-90,143400,143700,25495,961905,943905,OK
878.221674,delay,Tick,2184,2094,90,-90,143400,143700,25495,961905,943905,OK
878.546417,delay,Tick,2184,2094,90,-90,143400,144000,25495,961905,943905,OK
878.731624,delay,Tick,2184,2094,90,-90,143400,144100,25495,961905,943905,OK
879.046859,delay,Tick,2184,2094,90,-90,143400,144100,25495,961905,943905,OK
879.300139,delay,Tick,2184,2094,90,-90,143400,144000,25495,961905,943905,OK
879.459407,delay,Tick,2184,2094,90,-90,143400,144000,25495,961905,943905,OK
879.722722,delay,Tick,2184,2094,90,-90,143400,144000,25495,961905,943905,OK
880.020461,delay,Tick,2184,2094,90,-90,143400,144000,25495,961905,943905,OK
880.282426,delay,Tick,2184,2094,90,-90,143400,144000,25495,961905,943905,OK
880.466044,delay,Tick,2184,2094,90,-90,143400,144000,25495,961905,943905,OK
880.744782,delay,Tick,2184,2094,90,-90,143400,144000,25495,961905,943905,OK
881.000746,delay,Tick,2184,2094,90,-90,143400,144000,25495,961905,943905,OK
881.24954,delay,Tick,2184,2094,90,-90,143400,144000,25495,961905,943905,OK
881.479153,delay,Tick,2184,2094,90,-90,143400,144000,25495,961905,943905,OK
881.712838,delay,Tick,2184,2094,90,-90,143600,144000,25495,961905,943905,OK
881.963583,delay,Tick,2184,2094,90,-90,143600,144000,25495,961905,943905,OK
882.257111,delay,Tick,2184,2094,90,-90,143600,143900,25495,961905,943905,OK
882.545404,delay,Tick,2184,2094,90,-90,143600,143900,25495,961905,943905,OK
882.773939,delay,Tick,2184,2094,90,-90,143600,143900,25495,961905,943905,OK
882.964715,delay,Tick,2184,2094,90,-90,143600,143900,25495,961905,943905,OK
883.263032,delay,Tick,2184,2094,90,-90,143600,143800,25495,961905,943905,OK
883.516439,delay,Tick,2184,2094,90,-90,143600,143800,25495,961905,943905,OK
883.72357,delay,Tick,2184,2094,90,-90,143300,143800,25495,961905,943905,OK
883.957784,delay,Tick,2184,2094,90,-90,143300,143800,25495,961905,943905,OK
884.289036,delay,Tick,2184,2094,90,-90,143700,143800,25495,961905,952905,OK
884.494702,delay,Tick,2184,2094,90,-90,143700,143800,25495,961905,952905,OK
884.737541,delay,Tick,2184,2094,90,-90,143700,143800,25495,961905,952905,OK
885.018485,delay,Tick,2184,2094,90,-90,143700,143800,25495,961905,952905,OK
885.21691,delay,Tick,2184,2094,90,-90,143700,143800,25495,961905,952905,OK
885.531651,delay,Tick,2184,2094,90,-90,143700,143800,25495,961905,952905,OK
885.763205,delay,Tick,2184,2094,90,-90,143700,143800,25495,961905,952905,OK
886.048704,delay,Tick,2184,2094,90,-90,143700,143800,25495,961905,952905,OK
886.279497,delay,Tick,2184,2094,90,-90,143700,143800,25495,961905,952905,OK
886.515126,delay,Tick,2184,2094,90,-90,143700,143800,25495,961905,952905,OK
886.751402,delay,Tick,2184,2094,90,-90,143700,143800,25495,961905,952905,OK
886.974729,delay,Tick,2184,2094,90,-90,143700,143800,25495,961905,952905,OK
887.208082,delay,Tick,2184,2094,90,-90,143700,143800,25495,961905,952905,OK
887.473421,delay,Tick,2184,2094,90,-90,143300,143800,25495,961905,943905,OK
887.780794,delay,Tick,2184,2094,90,-90,143300,143800,25495,961905,943905,OK
888.040233,delay,Tick,2184,2094,90,-90,143300,143800,25495,961905,943905,OK
888.271118,delay,Tick,2184,2094,90,-90,143300,143800,25495,961905,943905,OK
888.494548,delay,Tick,2184,2094,90,-90,143600,143800,25495,961905,943905,OK
888.789695,delay,Tick,2184,2094,90,-90,143600,143800,25495,961905,943905,OK
888.960109,delay,Tick,2184,2094,90,-90,143600,143800,25495,961905,943905,OK
889.20423,delay,Tick,2184,2094,90,-90,143600,143800,25495,961905,943905,OK
889.538666,delay,Tick,2184,2094,90,-90,143400,143700,25495,961905,943905,OK
889.763113,delay,Tick,2184,2094,90,-90,143400,143700,25495,961905,943905,OK
889.960717,delay,Tick,2184,2094,90,-90,143400,143700,25495,961905,943905,OK
890.265166,delay,Tick,2184,2094,90,-90,143400,143700,25495,961905,943905,OK
890.461809,delay,Tick,2184,2094,90,-90,143400,143700,25495,961905,943905,OK
890.728475,delay,Tick,2184,2094,90,-90,143400,143700,25495,961905,943905,OK
891.021062,delay,Tick,2184,2094,90,-90,143400,143700,25495,961905,943905,OK
891.292913,delay,Tick,2184,2094,90,-90,143400,143900,25495,961905,943905,OK
891.537671,delay,Tick,2184,2094,90,-90,143700,143900,25495,961905,943905,OK
891.77787,delay,Tick,2184,2094,90,-90,143700,143900,25495,961905,943905,OK
892.01654,delay,Tick,2184,2094,90,-90,143700,143900,25495,961905,943905,OK
892.269247,delay,Tick,2184,2094,90,-90,143700,143900,25495,961905,943905,OK
892.495054,delay,Tick,2184,2094,90,-90,143400,143900,25495,961905,943905,OK
892.717198,delay,Tick,2184,2094,90,-90,143400,143900,25495,961905,943905,OK
892.961797,delay,Tick,2184,2094,90,-90,143400,143900,25495,961905,943905,OK
893.224117,delay,Tick,2184,2094,90,-90,143400,143900,25495,961905,943905,OK
893.533956,delay,Tick,2184,2094,90,-90,143700,143900,25495,961905,943905,OK
893.783371,delay,Tick,2184,2094,90,-90,143700,143700,25495,961905,961905,OK
893.982582,delay,Tick,2184,2094,90,-90,143700,143700,25495,961905,961905,OK
894.225563,delay,Tick,2184,2094,90,-90,143700,143700,25495,961905,961905,OK
894.543972,delay,Tick,2184,2094,90,-90,143700,143700,25495,961905,961905,OK
894.796806,delay,Tick,2184,2094,90,-90,143700,143700,25495,961905,961905,OK
895.016315,delay,Tick,2184,2094,90,-90,143700,143700,25495,961905,961905,OK
895.235907,delay,Tick,2184,2094,90,-90,143700,143700,25495,961905,961905,OK
895.55122,delay,Tick,2184,2094,90,-90,143700,143700,25495,961905,961905,OK
895.769142,delay,Tick,2184,2094,90,-90,143700,143700,25495,961905,961905,OK
895.96573,delay,Tick,2184,2094,90,-90,143700,143700,25495,961905,961905,OK
896.257687,delay,Tick,2184,2094,90,-90,143700,143700,25495,961905,961905,OK
896.516735,delay,Tick,2184,2094,90,-90,143700,143700,25495,961905,961905,OK
896.768919,delay,Tick,2184,2094,90,-90,143700,143800,25495,961905,952905,OK
896.990203,delay,Tick,2184,2094,90,-90,143700,143800,25495,961905,952905,OK
897.248379,delay,Tick,2184,2094,90,-90,143700,143700,25495,961905,961905,OK
897.550322,delay,Tick,2184,2094,90,-90,143400,143700,25495,961905,943905,OK
897.735414,delay,Tick,2184,2094,90,-90,143200,143700,25495,961905,943905,OK
897.973707,delay,Tick,2184,2094,90,-90,143200,143700,25495,961905,943905,OK
898.24513,delay,Tick,2184,2094,90,-90,143700,143900,25495,961905,943905,OK
898.522331,delay,Tick,2184,2094,90,-90,143700,143800,25495,961905,952905,OK
898.762486,delay,Tick,2184,2094,90,-90,143800,143800,25495,961905,961905,OK
899.036493,delay,Tick,2184,2094,90,-90,143800,143700,25495,961905,970905,OK
899.201084,delay,Tick,2184,2094,90,-90,143800,143500,25495,961905,979905,OK
899.539748,delay,Tick,2184,2094,90,-90,143000,143500,25495,961905,943905,OK
899.73314,delay,Tick,2184,2094,90,-90,143000,143500,25495,961905,943905,OK
899.967035,delay,Tick,2184,2094,90,-90,143000,143500,25495,961905,943905,OK
900.248299,delay,Tick,2184,2094,90,-90,143000,143500,25495,961905,943905,OK
